"filename", "language", "C++", "Python", "Shell Script", "Markdown", "comment", "blank", "total"
"d:\OI\Code\ACWing\1010.cpp", "C++", 44, 0, 0, 0, 0, 11, 55
"d:\OI\Code\ACWing\1012.cpp", "C++", 48, 0, 0, 0, 0, 11, 59
"d:\OI\Code\ACWing\1014.cpp", "C++", 52, 0, 0, 0, 0, 11, 63
"d:\OI\Code\ACWing\1015.cpp", "C++", 45, 0, 0, 0, 0, 9, 54
"d:\OI\Code\ACWing\1016.cpp", "C++", 40, 0, 0, 0, 0, 5, 45
"d:\OI\Code\ACWing\1017.cpp", "C++", 59, 0, 0, 0, 0, 11, 70
"d:\OI\Code\ACWing\1018.cpp", "C++", 42, 0, 0, 0, 0, 9, 51
"d:\OI\Code\ACWing\1027.cpp", "C++", 51, 0, 0, 0, 0, 7, 58
"d:\OI\Code\ACWing\104.cpp", "C++", 34, 0, 0, 0, 0, 10, 44
"d:\OI\Code\ACWing\143.cpp", "C++", 74, 0, 0, 0, 0, 9, 83
"d:\OI\Code\ACWing\154.cpp", "C++", 59, 0, 0, 0, 0, 11, 70
"d:\OI\Code\ACWing\187.cpp", "C++", 58, 0, 0, 0, 0, 16, 74
"d:\OI\Code\ACWing\2.cpp", "C++", 35, 0, 0, 0, 0, 7, 42
"d:\OI\Code\ACWing\204.cpp", "C++", 97, 0, 0, 0, 0, 18, 115
"d:\OI\Code\ACWing\272.cpp", "C++", 43, 0, 0, 0, 0, 9, 52
"d:\OI\Code\ACWing\275.cpp", "C++", 52, 0, 0, 0, 0, 11, 63
"d:\OI\Code\ACWing\2816.cpp", "C++", 49, 0, 0, 0, 0, 6, 55
"d:\OI\Code\ACWing\3.cpp", "C++", 34, 0, 0, 0, 0, 7, 41
"d:\OI\Code\ACWing\3302.cpp", "C++", 82, 0, 0, 0, 0, 12, 94
"d:\OI\Code\ACWing\4.cpp", "C++", 51, 0, 0, 0, 0, 10, 61
"d:\OI\Code\ACWing\482.cpp", "C++", 52, 0, 0, 0, 0, 10, 62
"d:\OI\Code\ACWing\5.cpp", "C++", 17, 0, 0, 0, 0, 3, 20
"d:\OI\Code\ACWing\786.cpp", "C++", 34, 0, 0, 0, 0, 7, 41
"d:\OI\Code\ACWing\787.cpp", "C++", 54, 0, 0, 0, 5, 9, 68
"d:\OI\Code\ACWing\789.cpp", "C++", 72, 0, 0, 0, 0, 9, 81
"d:\OI\Code\ACWing\790.cpp", "C++", 37, 0, 0, 0, 0, 5, 42
"d:\OI\Code\ACWing\791.cpp", "C++", 48, 0, 0, 0, 0, 8, 56
"d:\OI\Code\ACWing\792.cpp", "C++", 100, 0, 0, 0, 0, 12, 112
"d:\OI\Code\ACWing\793.cpp", "C++", 50, 0, 0, 0, 0, 9, 59
"d:\OI\Code\ACWing\794.cpp", "C++", 54, 0, 0, 0, 0, 9, 63
"d:\OI\Code\ACWing\795.cpp", "C++", 41, 0, 0, 0, 0, 6, 47
"d:\OI\Code\ACWing\796.cpp", "C++", 56, 0, 0, 0, 0, 9, 65
"d:\OI\Code\ACWing\797.cpp", "C++", 56, 0, 0, 0, 0, 9, 65
"d:\OI\Code\ACWing\798.cpp", "C++", 83, 0, 0, 0, 0, 12, 95
"d:\OI\Code\ACWing\799.cpp", "C++", 48, 0, 0, 0, 0, 8, 56
"d:\OI\Code\ACWing\800.cpp", "C++", 48, 0, 0, 0, 0, 8, 56
"d:\OI\Code\ACWing\801.cpp", "C++", 45, 0, 0, 0, 0, 5, 50
"d:\OI\Code\ACWing\802.cpp", "C++", 75, 0, 0, 0, 0, 13, 88
"d:\OI\Code\ACWing\803.cpp", "C++", 59, 0, 0, 0, 0, 11, 70
"d:\OI\Code\ACWing\826.cpp", "C++", 79, 0, 0, 0, 0, 11, 90
"d:\OI\Code\ACWing\830.cpp", "C++", 42, 0, 0, 0, 0, 8, 50
"d:\OI\Code\ACWing\831.cpp", "C++", 51, 0, 0, 0, 0, 9, 60
"d:\OI\Code\ACWing\835.cpp", "C++", 71, 0, 0, 0, 0, 6, 77
"d:\OI\Code\ACWing\836.cpp", "C++", 64, 0, 0, 0, 0, 11, 75
"d:\OI\Code\ACWing\837.cpp", "C++", 85, 0, 0, 0, 0, 15, 100
"d:\OI\Code\ACWing\838_a.cpp", "C++", 57, 0, 0, 0, 0, 11, 68
"d:\OI\Code\ACWing\839.cpp", "C++", 102, 0, 0, 0, 4, 11, 117
"d:\OI\Code\ACWing\840.cpp", "C++", 68, 0, 0, 0, 0, 6, 74
"d:\OI\Code\ACWing\840_a.cpp", "C++", 44, 0, 0, 0, 4, 5, 53
"d:\OI\Code\ACWing\840_b.cpp", "C++", 41, 0, 0, 0, 0, 7, 48
"d:\OI\Code\ACWing\841.cpp", "C++", 66, 0, 0, 0, 0, 11, 77
"d:\OI\Code\ACWing\842.cpp", "C++", 41, 0, 0, 0, 0, 7, 48
"d:\OI\Code\ACWing\843.cpp", "C++", 69, 0, 0, 0, 0, 10, 79
"d:\OI\Code\ACWing\844.cpp", "C++", 74, 0, 0, 0, 0, 15, 89
"d:\OI\Code\ACWing\845.cpp", "C++", 70, 0, 0, 0, 0, 14, 84
"d:\OI\Code\ACWing\846.cpp", "C++", 71, 0, 0, 0, 0, 13, 84
"d:\OI\Code\ACWing\847.cpp", "C++", 66, 0, 0, 0, 0, 10, 76
"d:\OI\Code\ACWing\848.cpp", "C++", 86, 0, 0, 0, 0, 13, 99
"d:\OI\Code\ACWing\849.cpp", "C++", 87, 0, 0, 0, 0, 15, 102
"d:\OI\Code\ACWing\850.cpp", "C++", 91, 0, 0, 0, 0, 15, 106
"d:\OI\Code\ACWing\851.cpp", "C++", 96, 0, 0, 0, 0, 16, 112
"d:\OI\Code\ACWing\852.cpp", "C++", 114, 0, 0, 0, 0, 17, 131
"d:\OI\Code\ACWing\853.cpp", "C++", 78, 0, 0, 0, 0, 12, 90
"d:\OI\Code\ACWing\866.cpp", "C++", 52, 0, 0, 0, 0, 7, 59
"d:\OI\Code\ACWing\867.cpp", "C++", 61, 0, 0, 0, 0, 9, 70
"d:\OI\Code\ACWing\868.cpp", "C++", 52, 0, 0, 0, 0, 7, 59
"d:\OI\Code\ACWing\869.cpp", "C++", 52, 0, 0, 0, 0, 7, 59
"d:\OI\Code\ACWing\870.cpp", "C++", 54, 0, 0, 0, 0, 9, 63
"d:\OI\Code\ACWing\871.cpp", "C++", 59, 0, 0, 0, 0, 9, 68
"d:\OI\Code\ACWing\872.cpp", "C++", 38, 0, 0, 0, 0, 6, 44
"d:\OI\Code\ACWing\873.cpp", "C++", 47, 0, 0, 0, 0, 5, 52
"d:\OI\Code\ACWing\874.cpp", "C++", 62, 0, 0, 0, 0, 9, 71
"d:\OI\Code\ACWing\875.cpp", "C++", 53, 0, 0, 0, 0, 6, 59
"d:\OI\Code\ACWing\876.cpp", "C++", 59, 0, 0, 0, 0, 4, 63
"d:\OI\Code\ACWing\877.cpp", "C++", 47, 0, 0, 0, 0, 5, 52
"d:\OI\Code\ACWing\878.cpp", "C++", 49, 0, 0, 0, 0, 6, 55
"d:\OI\Code\ACWing\883.cpp", "C++", 113, 0, 0, 0, 0, 16, 129
"d:\OI\Code\ACWing\891.cpp", "C++", 35, 0, 0, 0, 0, 6, 41
"d:\OI\Code\ACWing\895.cpp", "C++", 45, 0, 0, 0, 0, 7, 52
"d:\OI\Code\ACWing\896.cpp", "C++", 45, 0, 0, 0, 0, 7, 52
"d:\OI\Code\ACWing\897.cpp", "C++", 42, 0, 0, 0, 0, 9, 51
"d:\OI\Code\ACWing\898.cpp", "C++", 46, 0, 0, 0, 0, 9, 55
"d:\OI\Code\ACWing\899.cpp", "C++", 66, 0, 0, 0, 0, 14, 80
"d:\OI\Code\ACWing\902.cpp", "C++", 47, 0, 0, 0, 0, 11, 58
"d:\OI\Code\ACWing\907.cpp", "C++", 62, 0, 0, 0, 0, 13, 75
"d:\OI\Code\BOJ\20779.cpp", "C++", 66, 0, 0, 0, 3, 29, 98
"d:\OI\Code\BOJ\8354.cpp", "C++", 96, 0, 0, 0, 3, 29, 128
"d:\OI\Code\CSG\1217.cpp", "C++", 201, 0, 0, 0, 1, 49, 251
"d:\OI\Code\CSG\1223.cpp", "C++", 97, 0, 0, 0, 3, 30, 130
"d:\OI\Code\CodeChef\FINDINGSUM.cpp", "C++", 62, 0, 0, 0, 3, 18, 83
"d:\OI\Code\CodeforcesGym\Gym-105231D.cpp", "C++", 89, 0, 0, 0, 3, 27, 119
"d:\OI\Code\CodeforcesVP\1918A.cpp", "C++", 27, 0, 0, 0, 0, 10, 37
"d:\OI\Code\CodeforcesVP\1918B.cpp", "C++", 40, 0, 0, 0, 1, 17, 58
"d:\OI\Code\CodeforcesVP\1925A.cpp", "C++", 30, 0, 0, 0, 1, 11, 42
"d:\OI\Code\CodeforcesVP\1925B.cpp", "C++", 31, 0, 0, 0, 0, 12, 43
"d:\OI\Code\CodeforcesVP\1928A.cpp", "C++", 30, 0, 0, 0, 0, 8, 38
"d:\OI\Code\CodeforcesVP\1928B.cpp", "C++", 38, 0, 0, 0, 1, 17, 56
"d:\OI\Code\CodeforcesVP\1929A.cpp", "C++", 35, 0, 0, 0, 0, 13, 48
"d:\OI\Code\CodeforcesVP\1929B.cpp", "C++", 30, 0, 0, 0, 0, 11, 41
"d:\OI\Code\CodeforcesVP\1929C.cpp", "C++", 31, 0, 0, 0, 0, 12, 43
"d:\OI\Code\CompRedo\2023SCzrD2T1.cpp", "C++", 37, 0, 0, 0, 0, 12, 49
"d:\OI\Code\CompRedo\栈序列.cpp", "C++", 179, 0, 0, 0, 12, 36, 227
"d:\OI\Code\CompRedo\栈序列_tree.cpp", "C++", 126, 0, 0, 0, 3, 27, 156
"d:\OI\Code\CompRedo\栈序列_模拟.cpp", "C++", 72, 0, 0, 0, 0, 13, 85
"d:\OI\Code\Comp\22-11-13 洛谷NOIP全程模拟\A.cpp", "C++", 29, 0, 0, 0, 0, 7, 36
"d:\OI\Code\Comp\22-11-13 洛谷NOIP全程模拟\A_1.cpp", "C++", 37, 0, 0, 0, 0, 4, 41
"d:\OI\Code\Comp\22-11-13 洛谷NOIP全程模拟\A_2.cpp", "C++", 61, 0, 0, 0, 5, 14, 80
"d:\OI\Code\Comp\22-11-13 洛谷NOIP全程模拟\A_3.cpp", "C++", 29, 0, 0, 0, 0, 7, 36
"d:\OI\Code\Comp\22-11-13 洛谷NOIP全程模拟\B.cpp", "C++", 129, 0, 0, 0, 10, 18, 157
"d:\OI\Code\Comp\22-11-13 洛谷NOIP全程模拟\B_1.cpp", "C++", 49, 0, 0, 0, 0, 9, 58
"d:\OI\Code\Comp\22-11-18 sg模拟\A.cpp", "C++", 52, 0, 0, 0, 1, 13, 66
"d:\OI\Code\Comp\22-11-18 sg模拟\A2.cpp", "C++", 217, 0, 0, 0, 0, 4, 221
"d:\OI\Code\Comp\22-11-18 sg模拟\A_py.py", "Python", 0, 4, 0, 0, 0, 1, 5
"d:\OI\Code\Comp\22-11-18 sg模拟\A_table.cpp", "C++", 21, 0, 0, 0, 1, 6, 28
"d:\OI\Code\Comp\22-11-18 sg模拟\C.cpp", "C++", 86, 0, 0, 0, 1, 14, 101
"d:\OI\Code\Comp\22-11-19 LGR2\A.cpp", "C++", 14, 0, 0, 0, 0, 5, 19
"d:\OI\Code\Comp\22-11-19 LGR2\B.cpp", "C++", 52, 0, 0, 0, 0, 12, 64
"d:\OI\Code\Comp\22-11-19 LGR2\C.cpp", "C++", 73, 0, 0, 0, 0, 10, 83
"d:\OI\Code\Comp\22-11-19 LGR2\C_1.cpp", "C++", 13, 0, 0, 0, 0, 4, 17
"d:\OI\Code\Comp\22-11-19 LGR2\C_2.cpp", "C++", 35, 0, 0, 0, 0, 7, 42
"d:\OI\Code\Comp\22-11-19 LGR2\C_debug.cpp", "C++", 73, 0, 0, 0, 0, 11, 84
"d:\OI\Code\Comp\22-11-19 LGR2\test.cpp", "C++", 15, 0, 0, 0, 0, 4, 19
"d:\OI\Code\Comp\22-11-19 LGR2\赛后\A.cpp", "C++", 83, 0, 0, 0, 2, 14, 99
"d:\OI\Code\Comp\22-11-19 LGR\A.cpp", "C++", 45, 0, 0, 0, 0, 7, 52
"d:\OI\Code\Comp\22-11-19 LGR\B.cpp", "C++", 16, 0, 0, 0, 0, 5, 21
"d:\OI\Code\Comp\22-11-19 LGR\C.cpp", "C++", 77, 0, 0, 0, 0, 12, 89
"d:\OI\Code\Comp\22-11-19 LGR\D.cpp", "C++", 117, 0, 0, 0, 1, 18, 136
"d:\OI\Code\Comp\22-11-19 LGR\D_sub2.cpp", "C++", 127, 0, 0, 0, 0, 17, 144
"d:\OI\Code\Comp\22-11-19 LGR\test.cpp", "C++", 10, 0, 0, 0, 0, 5, 15
"d:\OI\Code\Comp\22-11-20 luogu模拟\A.cpp", "C++", 29, 0, 0, 0, 0, 8, 37
"d:\OI\Code\Comp\22-11-20 sg模拟-J\D.cpp", "C++", 41, 0, 0, 0, 0, 12, 53
"d:\OI\Code\Comp\22-11-20 sg模拟-S\A.cpp", "C++", 48, 0, 0, 0, 0, 15, 63
"d:\OI\Code\Comp\22-11-20 sg模拟-S\C.cpp", "C++", 17, 0, 0, 0, 0, 4, 21
"d:\OI\Code\Comp\22-11-20 sg模拟-S\D.cpp", "C++", 91, 0, 0, 0, 4, 17, 112
"d:\OI\Code\Comp\22-11-20 sg模拟-S\D_1.cpp", "C++", 103, 0, 0, 0, 22, 16, 141
"d:\OI\Code\Comp\22-11-20 sg模拟-S\D_debug.cpp", "C++", 76, 0, 0, 0, 11, 15, 102
"d:\OI\Code\Comp\22-11-20 sg模拟-S\test.cpp", "C++", 15, 0, 0, 0, 0, 4, 19
"d:\OI\Code\Comp\22-11-21 coding c++\A.cpp", "C++", 17, 0, 0, 0, 0, 4, 21
"d:\OI\Code\Comp\22-11-21 coding c++\Acw1.cpp", "C++", 15, 0, 0, 0, 0, 6, 21
"d:\OI\Code\Comp\22-11-21 coding c++\B.cpp", "C++", 15, 0, 0, 0, 0, 4, 19
"d:\OI\Code\Comp\22-11-21 coding c++\G.cpp", "C++", 24, 0, 0, 0, 0, 9, 33
"d:\OI\Code\Comp\22-11-21 coding c++\M.cpp", "C++", 16, 0, 0, 0, 0, 6, 22
"d:\OI\Code\Comp\22-11-21 coding c++\T.cpp", "C++", 19, 0, 0, 0, 0, 4, 23
"d:\OI\Code\Comp\22-11-21 coding c++\V.cpp", "C++", 15, 0, 0, 0, 0, 4, 19
"d:\OI\Code\Comp\22-11-21 coding c++\W.cpp", "C++", 19, 0, 0, 0, 0, 4, 23
"d:\OI\Code\Comp\22-11-21 sg模拟-J\A.cpp", "C++", 69, 0, 0, 0, 0, 12, 81
"d:\OI\Code\Comp\22-11-21 sg模拟-J\B.cpp", "C++", 37, 0, 0, 0, 0, 9, 46
"d:\OI\Code\Comp\22-11-21 sg模拟-J\C.cpp", "C++", 36, 0, 0, 0, 0, 7, 43
"d:\OI\Code\Comp\22-11-21 sg模拟-J\D.cpp", "C++", 16, 0, 0, 0, 0, 5, 21
"d:\OI\Code\Comp\22-11-21 sg模拟-S\B.cpp", "C++", 14, 0, 0, 0, 0, 7, 21
"d:\OI\Code\Comp\22-11-21 sg模拟-S\C.cpp", "C++", 16, 0, 0, 0, 0, 6, 22
"d:\OI\Code\Comp\22-11-22 coding c++\A.cpp", "C++", 17, 0, 0, 0, 0, 6, 23
"d:\OI\Code\Comp\22-11-22 coding c++\B.cpp", "C++", 20, 0, 0, 0, 0, 6, 26
"d:\OI\Code\Comp\22-11-22 coding c++\C.cpp", "C++", 59, 0, 0, 0, 4, 9, 72
"d:\OI\Code\Comp\22-11-22 coding c++\D.cpp", "C++", 21, 0, 0, 0, 0, 7, 28
"d:\OI\Code\Comp\22-11-22 coding c++\aaaaa.cpp", "C++", 14, 0, 0, 0, 0, 5, 19
"d:\OI\Code\Comp\22-11-22 sg模拟-J\A.cpp", "C++", 43, 0, 0, 0, 0, 9, 52
"d:\OI\Code\Comp\22-11-22 sg模拟-J\B.cpp", "C++", 31, 0, 0, 0, 6, 9, 46
"d:\OI\Code\Comp\22-11-22 sg模拟-J\C.cpp", "C++", 60, 0, 0, 0, 6, 5, 71
"d:\OI\Code\Comp\22-11-22 sg模拟-J\C2.cpp", "C++", 0, 0, 0, 0, 0, 2, 2
"d:\OI\Code\Comp\22-11-22 sg模拟-S\A.cpp", "C++", 14, 0, 0, 0, 0, 5, 19
"d:\OI\Code\Comp\22-11-22 sg模拟-S\B.cpp", "C++", 47, 0, 0, 0, 0, 13, 60
"d:\OI\Code\Comp\22-11-22 sg模拟-S\C.cpp", "C++", 80, 0, 0, 0, 0, 14, 94
"d:\OI\Code\Comp\22-11-22 sg模拟-S\C1.cpp", "C++", 107, 0, 0, 0, 4, 17, 128
"d:\OI\Code\Comp\22-11-23 coding c++\A.cpp", "C++", 67, 0, 0, 0, 0, 12, 79
"d:\OI\Code\Comp\22-11-23 coding c++\B.cpp", "C++", 53, 0, 0, 0, 0, 10, 63
"d:\OI\Code\Comp\22-11-23 coding c++\C.cpp", "C++", 15, 0, 0, 0, 0, 4, 19
"d:\OI\Code\Comp\22-11-23 coding c++\D.cpp", "C++", 99, 0, 0, 0, 5, 16, 120
"d:\OI\Code\Comp\22-11-23 coding c++\OLE.cpp", "C++", 18, 0, 0, 0, 0, 4, 22
"d:\OI\Code\Comp\22-11-23 sg模拟-J\A.cpp", "C++", 85, 0, 0, 0, 0, 12, 97
"d:\OI\Code\Comp\22-11-23 sg模拟-J\B.cpp", "C++", 14, 0, 0, 0, 0, 5, 19
"d:\OI\Code\Comp\22-11-23 sg模拟-J\D.cpp", "C++", 78, 0, 0, 0, 0, 13, 91
"d:\OI\Code\Comp\22-11-23 sg模拟-J\P11.cpp", "C++", 27, 0, 0, 0, 0, 5, 32
"d:\OI\Code\Comp\22-11-23 sg模拟-J\P13.cpp", "C++", 33, 0, 0, 0, 2, 7, 42
"d:\OI\Code\Comp\22-11-23 sg模拟-S\A.cpp", "C++", 84, 0, 0, 0, 0, 17, 101
"d:\OI\Code\Comp\22-11-23 sg模拟-S\A1.cpp", "C++", 14, 0, 0, 0, 0, 5, 19
"d:\OI\Code\Comp\22-11-23 sg模拟-S\test.cpp", "C++", 7, 0, 0, 0, 0, 1, 8
"d:\OI\Code\Comp\22-11-25 sg模拟-J\D.cpp", "C++", 74, 0, 0, 0, 17, 6, 97
"d:\OI\Code\Comp\22-11-25 sg模拟-J\abc.cpp", "C++", 14, 0, 0, 0, 0, 5, 19
"d:\OI\Code\Comp\22-11-26 noip2022\barrack.cpp", "C++", 103, 0, 0, 0, 2, 15, 120
"d:\OI\Code\Comp\22-11-26 noip2022\match.cpp", "C++", 82, 0, 0, 0, 6, 11, 99
"d:\OI\Code\Comp\22-11-26 noip2022\noip2022.md", "Markdown", 0, 0, 0, 18, 0, 18, 36
"d:\OI\Code\Comp\22-11-26 noip2022\plant.cpp", "C++", 261, 0, 0, 0, 79, 22, 362
"d:\OI\Code\Comp\22-11-26 noip2022\曹天朗SD-867\曹天朗SD-867\match\match - 副本.cpp", "C++", 82, 0, 0, 0, 6, 11, 99
"d:\OI\Code\Comp\22-11-26 noip2022\曹天朗SD-867\曹天朗SD-867\match\match.cpp", "C++", 86, 0, 0, 0, 2, 11, 99
"d:\OI\Code\Comp\22-11-26 noip2022\曹天朗SD-867\曹天朗SD-867\plant\plant.cpp", "C++", 252, 0, 0, 0, 82, 25, 359
"d:\OI\Code\Comp\23-01-14 蓝桥杯test\A.cpp", "C++", 17, 0, 0, 0, 0, 5, 22
"d:\OI\Code\Comp\23-01-14 蓝桥杯test\B.cpp", "C++", 24, 0, 0, 0, 0, 4, 28
"d:\OI\Code\Comp\23-01-15 蓝桥杯\1\1.cpp", "C++", 12, 0, 0, 0, 0, 3, 15
"d:\OI\Code\Comp\23-01-15 蓝桥杯\1\1_a.cpp", "C++", 14, 0, 0, 0, 0, 3, 17
"d:\OI\Code\Comp\23-01-15 蓝桥杯\1\1_duipai.cpp", "C++", 9, 0, 0, 0, 0, 3, 12
"d:\OI\Code\Comp\23-01-15 蓝桥杯\2\2.cpp", "C++", 44, 0, 0, 0, 0, 6, 50
"d:\OI\Code\Comp\23-01-15 蓝桥杯\3\3.cpp", "C++", 53, 0, 0, 0, 0, 10, 63
"d:\OI\Code\Comp\23-01-15 蓝桥杯\4\4.cpp", "C++", 95, 0, 0, 0, 0, 13, 108
"d:\OI\Code\Comp\23-01-15 蓝桥杯\5\5.cpp", "C++", 51, 0, 0, 0, 0, 8, 59
"d:\OI\Code\Comp\23-01-15 蓝桥杯\5\5_a.cpp", "C++", 70, 0, 0, 0, 0, 10, 80
"d:\OI\Code\Comp\23-02-02 sg测试\A.cpp", "C++", 41, 0, 0, 0, 0, 11, 52
"d:\OI\Code\Comp\23-02-02 sg测试\B.cpp", "C++", 32, 0, 0, 0, 0, 9, 41
"d:\OI\Code\Comp\23-02-02 sg测试\C.cpp", "C++", 50, 0, 0, 0, 0, 11, 61
"d:\OI\Code\Comp\23-02-02 sg测试\D.cpp", "C++", 45, 0, 0, 0, 0, 11, 56
"d:\OI\Code\Comp\23-02-04 sg测试\A.cpp", "C++", 24, 0, 0, 0, 0, 8, 32
"d:\OI\Code\Comp\23-02-04 sg测试\B.cpp", "C++", 82, 0, 0, 0, 0, 13, 95
"d:\OI\Code\Comp\23-02-04 sg测试\D.cpp", "C++", 68, 0, 0, 0, 0, 11, 79
"d:\OI\Code\Comp\23-04-29 ABC\A.cpp", "C++", 31, 0, 0, 0, 0, 9, 40
"d:\OI\Code\Comp\23-04-29 ABC\B.cpp", "C++", 90, 0, 0, 0, 2, 15, 107
"d:\OI\Code\Comp\23-04-29 CF869\A.cpp", "C++", 51, 0, 0, 0, 0, 14, 65
"d:\OI\Code\Comp\23-05-01 LG\A.cpp", "C++", 16, 0, 0, 0, 0, 6, 22
"d:\OI\Code\Comp\23-05-01 LG\E.cpp", "C++", 51, 0, 0, 0, 0, 12, 63
"d:\OI\Code\Comp\23-05-01 LG\E_Table\Table1.cpp", "C++", 55, 0, 0, 0, 0, 13, 68
"d:\OI\Code\Comp\23-05-01 LG\E_Table\Table10.cpp", "C++", 55, 0, 0, 0, 0, 13, 68
"d:\OI\Code\Comp\23-05-01 LG\E_Table\Table2.cpp", "C++", 54, 0, 0, 0, 0, 13, 67
"d:\OI\Code\Comp\23-05-01 LG\E_Table\Table3.cpp", "C++", 54, 0, 0, 0, 0, 13, 67
"d:\OI\Code\Comp\23-05-01 LG\E_Table\Table4.cpp", "C++", 54, 0, 0, 0, 0, 13, 67
"d:\OI\Code\Comp\23-05-01 LG\E_Table\Table5.cpp", "C++", 54, 0, 0, 0, 0, 13, 67
"d:\OI\Code\Comp\23-05-01 LG\E_Table\Table6.cpp", "C++", 54, 0, 0, 0, 0, 13, 67
"d:\OI\Code\Comp\23-05-01 LG\E_Table\Table7.cpp", "C++", 54, 0, 0, 0, 0, 13, 67
"d:\OI\Code\Comp\23-05-01 LG\E_Table\Table8.cpp", "C++", 54, 0, 0, 0, 0, 13, 67
"d:\OI\Code\Comp\23-05-01 LG\E_Table\Table9.cpp", "C++", 54, 0, 0, 0, 0, 13, 67
"d:\OI\Code\Comp\23-05-01 LG\E_fast.cpp", "C++", 22, 0, 0, 0, 0, 9, 31
"d:\OI\Code\Comp\23-05-01 LG\E_table.cpp", "C++", 56, 0, 0, 0, 0, 12, 68
"d:\OI\Code\Comp\23-05-01 LG\Table_host.cpp", "C++", 14, 0, 0, 0, 0, 5, 19
"d:\OI\Code\Comp\23-05-14 蓝桥杯\A.cpp", "C++", 18, 0, 0, 0, 0, 7, 25
"d:\OI\Code\Comp\23-05-14 蓝桥杯\B.cpp", "C++", 39, 0, 0, 0, 0, 11, 50
"d:\OI\Code\Comp\23-05-14 蓝桥杯\C.cpp", "C++", 38, 0, 0, 0, 0, 8, 46
"d:\OI\Code\Comp\23-05-14 蓝桥杯\D.cpp", "C++", 36, 0, 0, 0, 0, 11, 47
"d:\OI\Code\Comp\23-05-14 蓝桥杯\E.cpp", "C++", 47, 0, 0, 0, 0, 12, 59
"d:\OI\Code\Comp\23-05-14 蓝桥杯\E2.cpp", "C++", 84, 0, 0, 0, 4, 24, 112
"d:\OI\Code\Comp\23-05-14 蓝桥杯\test\A.cpp", "C++", 17, 0, 0, 0, 0, 5, 22
"d:\OI\Code\Comp\23-05-14 蓝桥杯\test\B.cpp", "C++", 17, 0, 0, 0, 0, 5, 22
"d:\OI\Code\Comp\23-05-28 LG\A.cpp", "C++", 31, 0, 0, 0, 0, 7, 38
"d:\OI\Code\Comp\23-05-28 蓝桥杯国赛\A.cpp", "C++", 44, 0, 0, 0, 0, 9, 53
"d:\OI\Code\Comp\23-05-28 蓝桥杯国赛\B.cpp", "C++", 33, 0, 0, 0, 0, 8, 41
"d:\OI\Code\Comp\23-05-28 蓝桥杯国赛\C.cpp", "C++", 89, 0, 0, 0, 4, 14, 107
"d:\OI\Code\Comp\23-05-28 蓝桥杯国赛\D.cpp", "C++", 14, 0, 0, 0, 0, 5, 19
"d:\OI\Code\Comp\23-05-28 蓝桥杯国赛\E.cpp", "C++", 47, 0, 0, 0, 0, 11, 58
"d:\OI\Code\Comp\23-05-28 蓝桥杯国赛\F.cpp", "C++", 39, 0, 0, 0, 0, 10, 49
"d:\OI\Code\Comp\23-06-11 夏令营\A.cpp", "C++", 126, 0, 0, 0, 1, 22, 149
"d:\OI\Code\Comp\23-06-11 夏令营\B.cpp", "C++", 28, 0, 0, 0, 0, 8, 36
"d:\OI\Code\Comp\23-07-07 CF883\A.cpp", "C++", 39, 0, 0, 0, 0, 8, 47
"d:\OI\Code\Comp\23-07-07 CF883\B.cpp", "C++", 83, 0, 0, 0, 0, 14, 97
"d:\OI\Code\Comp\23-07-07 CF883\C.cpp", "C++", 74, 0, 0, 0, 8, 22, 104
"d:\OI\Code\Comp\23-07-08 LG\A.cpp", "C++", 39, 0, 0, 0, 0, 9, 48
"d:\OI\Code\Comp\23-07-08 LG\B.cpp", "C++", 66, 0, 0, 0, 0, 11, 77
"d:\OI\Code\Comp\23-07-09 ARC\A.cpp", "C++", 34, 0, 0, 0, 0, 10, 44
"d:\OI\Code\Comp\23-07-14 LG\A.cpp", "C++", 18, 0, 0, 0, 0, 7, 25
"d:\OI\Code\Comp\23-07-14 LG\B.cpp", "C++", 37, 0, 0, 0, 0, 12, 49
"d:\OI\Code\Comp\23-07-14 LG\C.cpp", "C++", 50, 0, 0, 0, 0, 11, 61
"d:\OI\Code\Comp\23-07-14 LG\C_1.cpp", "C++", 14, 0, 0, 0, 0, 5, 19
"d:\OI\Code\Comp\23-07-14 LG\D.cpp", "C++", 17, 0, 0, 0, 0, 8, 25
"d:\OI\Code\Comp\23-07-14 LG\E.cpp", "C++", 66, 0, 0, 0, 1, 14, 81
"d:\OI\Code\Comp\23-07-14 LG\F.cpp", "C++", 66, 0, 0, 0, 1, 14, 81
"d:\OI\Code\Comp\23-07-15 ABC\A.cpp", "C++", 28, 0, 0, 0, 0, 12, 40
"d:\OI\Code\Comp\23-07-15 ABC\B.cpp", "C++", 56, 0, 0, 0, 0, 14, 70
"d:\OI\Code\Comp\23-07-21 CF 886\A.cpp", "C++", 13, 0, 0, 0, 0, 8, 21
"d:\OI\Code\Comp\23-07-21 CF 886\B.cpp", "C++", 22, 0, 0, 0, 0, 8, 30
"d:\OI\Code\Comp\23-07-21 CF 886\C.cpp", "C++", 25, 0, 0, 0, 0, 10, 35
"d:\OI\Code\Comp\23-07-21 CF 886\D.cpp", "C++", 31, 0, 0, 0, 0, 14, 45
"d:\OI\Code\Comp\23-07-21 CF 886\E.cpp", "C++", 0, 0, 0, 0, 0, 1, 1
"d:\OI\Code\Comp\23-07-21 CF 886\F.cpp", "C++", 29, 0, 0, 0, 1, 15, 45
"d:\OI\Code\Comp\23-07-21 CF 886\G.cpp", "C++", 0, 0, 0, 0, 0, 1, 1
"d:\OI\Code\Comp\23-07-21 CF 886\H.cpp", "C++", 0, 0, 0, 0, 0, 1, 1
"d:\OI\Code\Comp\23-07-21 CF 886\tempCodeRunnerFile.py", "Python", 0, 0, 0, 0, 0, 1, 1
"d:\OI\Code\Comp\23-07-21 CF 886\test.py", "Python", 0, 59, 0, 0, 1, 23, 83
"d:\OI\Code\Comp\23-07-22 ABC311\A_First_ABC.cpp", "C++", 29, 0, 0, 0, 0, 9, 38
"d:\OI\Code\Comp\23-07-22 ABC311\B_Vacation_Together.cpp", "C++", 38, 0, 0, 0, 0, 13, 51
"d:\OI\Code\Comp\23-07-22 ABC311\C_Find_it.cpp", "C++", 55, 0, 0, 0, 1, 15, 71
"d:\OI\Code\Comp\23-07-22 ABC311\D_Grid_Ice_Floor.cpp", "C++", 65, 0, 0, 0, 0, 23, 88
"d:\OI\Code\Comp\23-07-22 LG\T_309754_yLOI_2022_枕万梦.cpp", "C++", 39, 0, 0, 0, 0, 13, 52
"d:\OI\Code\Comp\23-07-22 LG\T_348565_yLOI_2022_长安幻世绘.cpp", "C++", 120, 0, 0, 0, 3, 38, 161
"d:\OI\Code\Comp\23-07-22 LG\T_349349_yLOI_2022_西施江南.cpp", "C++", 89, 0, 0, 0, 4, 30, 123
"d:\OI\Code\Comp\23-07-22 LG\T_349358_yLOI_2022_签到题.cpp", "C++", 28, 0, 0, 0, 0, 9, 37
"d:\OI\Code\Comp\23-07-23 ZR\A.cpp", "C++", 96, 0, 0, 0, 15, 26, 137
"d:\OI\Code\Comp\23-07-23 ZR\A_2.cpp", "C++", 49, 0, 0, 0, 0, 12, 61
"d:\OI\Code\Comp\23-07-23 ZR\B.cpp", "C++", 51, 0, 0, 0, 0, 17, 68
"d:\OI\Code\Comp\23-07-23 ZR\C.cpp", "C++", 35, 0, 0, 0, 0, 13, 48
"d:\OI\Code\Comp\23-07-23 ZR\Redo\A.cpp", "C++", 55, 0, 0, 0, 3, 21, 79
"d:\OI\Code\Comp\23-07-23 ZR\Redo\temp.cpp", "C++", 6, 0, 0, 0, 0, 3, 9
"d:\OI\Code\Comp\23-07-25 CF\1851D.cpp", "C++", 47, 0, 0, 0, 2, 20, 69
"d:\OI\Code\Comp\23-07-25 CF\Escalator_Conversations.cpp", "C++", 32, 0, 0, 0, 0, 10, 42
"d:\OI\Code\Comp\23-07-25 CF\Parity_Sort.cpp", "C++", 47, 0, 0, 0, 0, 15, 62
"d:\OI\Code\Comp\23-07-28 ZR ACM\A.cpp", "C++", 19, 0, 0, 0, 0, 6, 25
"d:\OI\Code\Comp\23-07-28 ZR ACM\B.cpp", "C++", 32, 0, 0, 0, 1, 4, 37
"d:\OI\Code\Comp\23-07-28 ZR ACM\C.cpp", "C++", 46, 0, 0, 0, 0, 4, 50
"d:\OI\Code\Comp\23-07-28 ZR ACM\D.cpp", "C++", 19, 0, 0, 0, 0, 6, 25
"d:\OI\Code\Comp\23-07-28 ZR ACM\E.cpp", "C++", 28, 0, 0, 0, 0, 5, 33
"d:\OI\Code\Comp\23-07-28 ZR ACM\F.cpp", "C++", 50, 0, 0, 0, 15, 8, 73
"d:\OI\Code\Comp\23-07-28 ZR ACM\F2.cpp", "C++", 61, 0, 0, 0, 0, 22, 83
"d:\OI\Code\Comp\23-07-28 ZR ACM\G.cpp", "C++", 61, 0, 0, 0, 1, 7, 69
"d:\OI\Code\Comp\23-07-28 ZR ACM\H.cpp", "C++", 19, 0, 0, 0, 0, 6, 25
"d:\OI\Code\Comp\23-07-28 ZR ACM\I.cpp", "C++", 90, 0, 0, 0, 4, 20, 114
"d:\OI\Code\Comp\23-07-28 ZR ACM\J.cpp", "C++", 86, 0, 0, 0, 13, 3, 102
"d:\OI\Code\Comp\23-07-28 ZR ACM\K.cpp", "C++", 24, 0, 0, 0, 0, 7, 31
"d:\OI\Code\Comp\23-07-28 ZR ACM\L.cpp", "C++", 19, 0, 0, 0, 0, 6, 25
"d:\OI\Code\Comp\23-07-28 ZR ACM\M.cpp", "C++", 19, 0, 0, 0, 0, 6, 25
"d:\OI\Code\Comp\23-07-28 ZR ACM\model.cpp", "C++", 19, 0, 0, 0, 0, 6, 25
"d:\OI\Code\Comp\23-07-28 ZR ACM\qwq.cpp", "C++", 29, 0, 0, 0, 0, 5, 34
"d:\OI\Code\Comp\23-07-28 ZR ACM\qwq2.cpp", "C++", 59, 0, 0, 0, 29, 7, 95
"d:\OI\Code\Comp\23-07-28 ZR ACM\未命名2.cpp", "C++", 26, 0, 0, 0, 0, 4, 30
"d:\OI\Code\Comp\23-07-28 ZR ACM\未命名3.cpp", "C++", 14, 0, 0, 0, 0, 5, 19
"d:\OI\Code\Comp\23-07-29 ABC312\A.cpp", "C++", 13, 0, 0, 0, 0, 5, 18
"d:\OI\Code\Comp\23-07-29 ABC312\B.cpp", "C++", 46, 0, 0, 0, 2, 21, 69
"d:\OI\Code\Comp\23-07-29 ABC312\C.cpp", "C++", 33, 0, 0, 0, 5, 16, 54
"d:\OI\Code\Comp\23-08-02 ZR\A.cpp", "C++", 70, 0, 0, 0, 0, 23, 93
"d:\OI\Code\Comp\23-08-02 ZR\B.cpp", "C++", 43, 0, 0, 0, 0, 13, 56
"d:\OI\Code\Comp\23-08-02 ZR\C.cpp", "C++", 27, 0, 0, 0, 0, 9, 36
"d:\OI\Code\Comp\23-08-02 ZR\PaiA\code.cpp", "C++", 65, 0, 0, 0, 0, 20, 85
"d:\OI\Code\Comp\23-08-02 ZR\PaiA\pai.cpp", "C++", 25, 0, 0, 0, 0, 9, 34
"d:\OI\Code\Comp\23-08-02 ZR\PaiA\scode.cpp", "C++", 73, 0, 0, 0, 1, 14, 88
"d:\OI\Code\Comp\23-08-04 ZR\A.cpp", "C++", 25, 0, 0, 0, 0, 10, 35
"d:\OI\Code\Comp\23-08-04 ZR\B.cpp", "C++", 50, 0, 0, 0, 4, 19, 73
"d:\OI\Code\Comp\23-08-04 ZR\B_1.cpp", "C++", 64, 0, 0, 0, 1, 19, 84
"d:\OI\Code\Comp\23-08-04 ZR\C.cpp", "C++", 27, 0, 0, 0, 0, 5, 32
"d:\OI\Code\Comp\23-08-04 ZR\cc.cpp", "C++", 52, 0, 0, 0, 0, 12, 64
"d:\OI\Code\Comp\23-08-04 ZR\d.cpp", "C++", 17, 0, 0, 0, 0, 7, 24
"d:\OI\Code\Comp\23-08-05 ABC313\A.cpp", "C++", 33, 0, 0, 0, 0, 13, 46
"d:\OI\Code\Comp\23-08-05 ABC313\B.cpp", "C++", 36, 0, 0, 0, 0, 10, 46
"d:\OI\Code\Comp\23-08-05 ABC313\C.cpp", "C++", 36, 0, 0, 0, 0, 13, 49
"d:\OI\Code\Comp\23-08-05 ABC313\D.cpp", "C++", 32, 0, 0, 0, 1, 12, 45
"d:\OI\Code\Comp\23-08-08 ZR\A.cpp", "C++", 36, 0, 0, 0, 0, 14, 50
"d:\OI\Code\Comp\23-08-08 ZR\B.cpp", "C++", 0, 0, 0, 0, 0, 1, 1
"d:\OI\Code\Comp\23-08-08 ZR\C.cpp", "C++", 83, 0, 0, 0, 3, 28, 114
"d:\OI\Code\Comp\23-08-08 ZR\test.cpp", "C++", 20, 0, 0, 0, 0, 10, 30
"d:\OI\Code\Comp\23-08-12 ABC314\A.cpp", "C++", 12, 0, 0, 0, 0, 6, 18
"d:\OI\Code\Comp\23-08-12 ABC314\B.cpp", "C++", 33, 0, 0, 0, 0, 10, 43
"d:\OI\Code\Comp\23-08-12 ABC314\D.cpp", "C++", 38, 0, 0, 0, 17, 12, 67
"d:\OI\Code\Comp\23-08-12 ABC314\D_1.cpp", "C++", 45, 0, 0, 0, 0, 9, 54
"d:\OI\Code\Comp\23-08-12 ABC314\test.cpp", "C++", 6, 0, 0, 0, 0, 4, 10
"d:\OI\Code\Comp\23-08-13 ZR\A.cpp", "C++", 14, 0, 0, 0, 0, 7, 21
"d:\OI\Code\Comp\23-08-13 ZR\B.cpp", "C++", 29, 0, 0, 0, 0, 12, 41
"d:\OI\Code\Comp\23-08-13 ZR\C.cpp", "C++", 27, 0, 0, 0, 0, 10, 37
"d:\OI\Code\Comp\23-08-13 ZR\D.cpp", "C++", 27, 0, 0, 0, 0, 7, 34
"d:\OI\Code\Comp\23-08-15 ZR 收官之战\A.cpp", "C++", 51, 0, 0, 0, 2, 19, 72
"d:\OI\Code\Comp\23-08-15 ZR 收官之战\A_2.cpp", "C++", 29, 0, 0, 0, 0, 13, 42
"d:\OI\Code\Comp\23-08-15 ZR 收官之战\A_3.cpp", "C++", 17, 0, 0, 0, 0, 11, 28
"d:\OI\Code\Comp\23-08-15 ZR 收官之战\B.cpp", "C++", 65, 0, 0, 0, 0, 18, 83
"d:\OI\Code\Comp\23-08-15 ZR 收官之战\C.cpp", "C++", 20, 0, 0, 0, 0, 7, 27
"d:\OI\Code\Comp\23-08-15 ZR 收官之战\D.cpp", "C++", 77, 0, 0, 0, 0, 22, 99
"d:\OI\Code\Comp\23-08-18 SDCPC\A.cpp", "C++", 35, 0, 0, 0, 0, 13, 48
"d:\OI\Code\Comp\23-08-18 SDCPC\F.cpp", "C++", 43, 0, 0, 0, 0, 18, 61
"d:\OI\Code\Comp\23-08-18 SDCPC\G.cpp", "C++", 40, 0, 0, 0, 0, 16, 56
"d:\OI\Code\Comp\23-08-18 SDCPC\G1.cpp", "C++", 47, 0, 0, 0, 0, 19, 66
"d:\OI\Code\Comp\23-08-18 SDCPC\G_pai.cpp", "C++", 6, 0, 0, 0, 0, 4, 10
"d:\OI\Code\Comp\23-08-18 SDCPC\H.cpp", "C++", 16, 0, 0, 0, 0, 8, 24
"d:\OI\Code\Comp\23-08-18 SDCPC\I.cpp", "C++", 22, 0, 0, 0, 0, 12, 34
"d:\OI\Code\Comp\23-08-24 CF\A.cpp", "C++", 30, 0, 0, 0, 0, 9, 39
"d:\OI\Code\Comp\23-08-24 CF\B.cpp", "C++", 25, 0, 0, 0, 0, 11, 36
"d:\OI\Code\Comp\23-08-24 CF\C.cpp", "C++", 29, 0, 0, 0, 0, 12, 41
"d:\OI\Code\Comp\23-08-24 CF\E.cpp", "C++", 9, 0, 0, 0, 0, 4, 13
"d:\OI\Code\Comp\23-08-26 ABC317\A.cpp", "C++", 15, 0, 0, 0, 0, 8, 23
"d:\OI\Code\Comp\23-08-26 ABC317\B.cpp", "C++", 18, 0, 0, 0, 0, 9, 27
"d:\OI\Code\Comp\23-08-26 ABC317\C.cpp", "C++", 44, 0, 0, 0, 0, 12, 56
"d:\OI\Code\Comp\23-08-26 ABC317\C1.cpp", "C++", 40, 0, 0, 0, 0, 13, 53
"d:\OI\Code\Comp\23-08-26 ABC317\D.cpp", "C++", 33, 0, 0, 0, 0, 14, 47
"d:\OI\Code\Comp\23-08-27 ZR-NOIP-1\A.cpp", "C++", 29, 0, 0, 0, 0, 11, 40
"d:\OI\Code\Comp\23-08-27 ZR-NOIP-1\A1.cpp", "C++", 23, 0, 0, 0, 0, 13, 36
"d:\OI\Code\Comp\23-08-27 ZR-NOIP-1\B.cpp", "C++", 62, 0, 0, 0, 1, 19, 82
"d:\OI\Code\Comp\23-08-27 ZR-NOIP-1\C.cpp", "C++", 71, 0, 0, 0, 0, 22, 93
"d:\OI\Code\Comp\23-08-27 ZR-NOIP-1\D.cpp", "C++", 17, 0, 0, 0, 0, 7, 24
"d:\OI\Code\Comp\23-08-27 ZR-NOIP-1\test.cpp", "C++", 7, 0, 0, 0, 0, 3, 10
"d:\OI\Code\Comp\23-09-02 ZR-CSP-1\A.cpp", "C++", 62, 0, 0, 0, 5, 20, 87
"d:\OI\Code\Comp\23-09-02 ZR-CSP-1\B.cpp", "C++", 52, 0, 0, 0, 0, 18, 70
"d:\OI\Code\Comp\23-09-02 ZR-CSP-1\C.cpp", "C++", 34, 0, 0, 0, 0, 12, 46
"d:\OI\Code\Comp\23-09-02 ZR-CSP-1\D.cpp", "C++", 31, 0, 0, 0, 0, 14, 45
"d:\OI\Code\Comp\23-09-03 ZR-NOIP-2\A.cpp", "C++", 33, 0, 0, 0, 22, 16, 71
"d:\OI\Code\Comp\23-09-03 ZR-NOIP-2\B.cpp", "C++", 67, 0, 0, 0, 0, 19, 86
"d:\OI\Code\Comp\23-09-03 ZR-NOIP-2\C.cpp", "C++", 41, 0, 0, 0, 7, 14, 62
"d:\OI\Code\Comp\23-09-03 ZR-NOIP-2\C_test.cpp", "C++", 23, 0, 0, 0, 0, 6, 29
"d:\OI\Code\Comp\23-09-03 ZR-NOIP-2\D.cpp", "C++", 113, 0, 0, 0, 0, 23, 136
"d:\OI\Code\Comp\23-09-03 ZR-NOIP-2\D_fhq.cpp", "C++", 64, 0, 0, 0, 0, 13, 77
"d:\OI\Code\Comp\23-09-09 ZR-CSP-2\A.cpp", "C++", 26, 0, 0, 0, 0, 12, 38
"d:\OI\Code\Comp\23-09-09 ZR-CSP-2\B.cpp", "C++", 35, 0, 0, 0, 0, 19, 54
"d:\OI\Code\Comp\23-09-09 ZR-CSP-2\C.cpp", "C++", 40, 0, 0, 0, 1, 22, 63
"d:\OI\Code\Comp\23-09-09 ZR-CSP-2\D.cpp", "C++", 98, 0, 0, 0, 0, 35, 133
"d:\OI\Code\Comp\23-09-10 ZR-NOIP-3\A.cpp", "C++", 104, 0, 0, 0, 0, 41, 145
"d:\OI\Code\Comp\23-09-10 ZR-NOIP-3\C.cpp", "C++", 115, 0, 0, 0, 3, 51, 169
"d:\OI\Code\Comp\23-09-23 ZR-CSP-4\A.cpp", "C++", 56, 0, 0, 0, 0, 22, 78
"d:\OI\Code\Comp\23-09-23 ZR-CSP-4\B.cpp", "C++", 84, 0, 0, 0, 0, 38, 122
"d:\OI\Code\Comp\23-09-23 ZR-CSP-4\C.cpp", "C++", 37, 0, 0, 0, 0, 21, 58
"d:\OI\Code\Comp\23-09-23 ZR-CSP-4\D.cpp", "C++", 91, 0, 0, 0, 1, 35, 127
"d:\OI\Code\Comp\23-09-23 ZR-CSP-4\Redo\A.cpp", "C++", 35, 0, 0, 0, 0, 17, 52
"d:\OI\Code\Comp\23-09-23 ZR-CSP-4\Redo\B.cpp", "C++", 49, 0, 0, 0, 0, 19, 68
"d:\OI\Code\Comp\23-09-28 duel\A.cpp", "C++", 44, 0, 0, 0, 7, 17, 68
"d:\OI\Code\Comp\23-09-28 duel\B.cpp", "C++", 30, 0, 0, 0, 0, 11, 41
"d:\OI\Code\Comp\23-09-29 QBXT-Day1\A.cpp", "C++", 45, 0, 0, 0, 0, 16, 61
"d:\OI\Code\Comp\23-09-29 QBXT-Day1\A1.cpp", "C++", 54, 0, 0, 0, 0, 20, 74
"d:\OI\Code\Comp\23-09-29 QBXT-Day1\B.cpp", "C++", 50, 0, 0, 0, 0, 21, 71
"d:\OI\Code\Comp\23-09-29 QBXT-Day1\B.py", "Python", 0, 4, 0, 0, 0, 2, 6
"d:\OI\Code\Comp\23-09-29 QBXT-Day1\C.cpp", "C++", 8, 0, 0, 0, 0, 5, 13
"d:\OI\Code\Comp\23-09-29 QBXT-Day1\D.cpp", "C++", 119, 0, 0, 0, 6, 49, 174
"d:\OI\Code\Comp\23-09-29 QBXT-Day1\Redo\B.cpp", "C++", 48, 0, 0, 0, 6, 26, 80
"d:\OI\Code\Comp\23-09-29 QBXT-Day1\Redo\D.cpp", "C++", 103, 0, 0, 0, 4, 54, 161
"d:\OI\Code\Comp\23-09-30 QBXT-Day2\A.cpp", "C++", 78, 0, 0, 0, 0, 33, 111
"d:\OI\Code\Comp\23-09-30 QBXT-Day2\B.cpp", "C++", 119, 0, 0, 0, 0, 54, 173
"d:\OI\Code\Comp\23-09-30 QBXT-Day2\Redo\A.cpp", "C++", 74, 0, 0, 0, 0, 30, 104
"d:\OI\Code\Comp\23-10-01 QBXT-Day3\A.cpp", "C++", 51, 0, 0, 0, 0, 22, 73
"d:\OI\Code\Comp\23-10-01 QBXT-Day3\B.cpp", "C++", 57, 0, 0, 0, 0, 24, 81
"d:\OI\Code\Comp\23-10-01 QBXT-Day3\C.cpp", "C++", 86, 0, 0, 0, 0, 34, 120
"d:\OI\Code\Comp\23-10-01 QBXT-Day3\Redo\B.cpp", "C++", 61, 0, 0, 0, 0, 25, 86
"d:\OI\Code\Comp\23-10-02 QBXT-Day4\A.cpp", "C++", 67, 0, 0, 0, 0, 23, 90
"d:\OI\Code\Comp\23-10-02 QBXT-Day4\B.cpp", "C++", 50, 0, 0, 0, 0, 14, 64
"d:\OI\Code\Comp\23-10-02 QBXT-Day4\B_rand.cpp", "C++", 10, 0, 0, 0, 0, 5, 15
"d:\OI\Code\Comp\23-10-02 QBXT-Day4\C.cpp", "C++", 79, 0, 0, 0, 0, 34, 113
"d:\OI\Code\Comp\23-10-02 QBXT-Day4\C_table.cpp", "C++", 8, 0, 0, 0, 0, 4, 12
"d:\OI\Code\Comp\23-10-02 QBXT-Day4\D.cpp", "C++", 54, 0, 0, 0, 0, 24, 78
"d:\OI\Code\Comp\23-10-02 QBXT-Day4\Redo\A.cpp", "C++", 37, 0, 0, 0, 1, 19, 57
"d:\OI\Code\Comp\23-10-03 QBXT-Day5\A.cpp", "C++", 90, 0, 0, 0, 1, 33, 124
"d:\OI\Code\Comp\23-10-03 QBXT-Day5\B.cpp", "C++", 49, 0, 0, 0, 1, 21, 71
"d:\OI\Code\Comp\23-10-03 QBXT-Day5\C.cpp", "C++", 29, 0, 0, 0, 0, 14, 43
"d:\OI\Code\Comp\23-10-03 QBXT-Day5\D.cpp", "C++", 66, 0, 0, 0, 0, 25, 91
"d:\OI\Code\Comp\23-10-03 QBXT-Day5\Redo\C.cpp", "C++", 50, 0, 0, 0, 0, 22, 72
"d:\OI\Code\Comp\23-10-04 QBXT-Day6\A.cpp", "C++", 83, 0, 0, 0, 0, 23, 106
"d:\OI\Code\Comp\23-10-04 QBXT-Day6\B.cpp", "C++", 70, 0, 0, 0, 0, 24, 94
"d:\OI\Code\Comp\23-10-04 QBXT-Day6\C.cpp", "C++", 100, 0, 0, 0, 2, 32, 134
"d:\OI\Code\Comp\23-10-05 QBXT-Day7\A.cpp", "C++", 86, 0, 0, 0, 53, 31, 170
"d:\OI\Code\Comp\23-10-05 QBXT-Day7\B.cpp", "C++", 71, 0, 0, 0, 111, 50, 232
"d:\OI\Code\Comp\23-10-05 QBXT-Day7\D.cpp", "C++", 32, 0, 0, 0, 0, 17, 49
"d:\OI\Code\Comp\23-10-05 QBXT-Day7\D.py", "Python", 0, 10, 0, 0, 0, 4, 14
"d:\OI\Code\Comp\23-10-14 ZR-CSP-7\A.cpp", "C++", 17, 0, 0, 0, 0, 8, 25
"d:\OI\Code\Comp\23-10-14 ZR-CSP-7\B.cpp", "C++", 43, 0, 0, 0, 5, 20, 68
"d:\OI\Code\Comp\23-10-14 ZR-CSP-7\C\C.cpp", "C++", 81, 0, 0, 0, 6, 33, 120
"d:\OI\Code\Comp\23-10-14 ZR-CSP-7\C\C2.cpp", "C++", 82, 0, 0, 0, 3, 32, 117
"d:\OI\Code\Comp\23-10-14 ZR-CSP-7\C\C_std.cpp", "C++", 47, 0, 0, 0, 500006, 8, 500061
"d:\OI\Code\Comp\23-10-14 ZR-CSP-7\C_1.cpp", "C++", 65, 0, 0, 0, 0, 30, 95
"d:\OI\Code\Comp\23-10-14 ZR-CSP-7\Redo\B.cpp", "C++", 23, 0, 0, 0, 0, 11, 34
"d:\OI\Code\Comp\23-10-20 duel\1.cpp", "C++", 20, 0, 0, 0, 0, 11, 31
"d:\OI\Code\Comp\23-10-20 duel\2.cpp", "C++", 18, 0, 0, 0, 0, 11, 29
"d:\OI\Code\Comp\23-10-20 duel\3.cpp", "C++", 28, 0, 0, 0, 0, 11, 39
"d:\OI\Code\Comp\23-10-20 duel\4.cpp", "C++", 30, 0, 0, 0, 0, 11, 41
"d:\OI\Code\Comp\23-10-28 ABC326\A.cpp", "C++", 20, 0, 0, 0, 0, 6, 26
"d:\OI\Code\Comp\23-10-28 ABC326\B.cpp", "C++", 16, 0, 0, 0, 0, 8, 24
"d:\OI\Code\Comp\23-10-28 ABC326\C.cpp", "C++", 20, 0, 0, 0, 0, 10, 30
"d:\OI\Code\Comp\23-10-28 ABC326\D.cpp", "C++", 54, 0, 0, 0, 0, 18, 72
"d:\OI\Code\Comp\23-11-08 QCM\A.cpp", "C++", 41, 0, 0, 0, 0, 17, 58
"d:\OI\Code\Comp\23-11-08 ZR-NOIP-4\A.cpp", "C++", 42, 0, 0, 0, 0, 16, 58
"d:\OI\Code\Comp\23-11-08 ZR-NOIP-4\C.cpp", "C++", 86, 0, 0, 0, 5, 32, 123
"d:\OI\Code\Comp\23-11-08 ZR-NOIP-4\D.cpp", "C++", 43, 0, 0, 0, 5, 19, 67
"d:\OI\Code\Comp\23-11-08 ZR-NOIP-5\A.cpp", "C++", 57, 0, 0, 0, 6, 23, 86
"d:\OI\Code\Comp\23-11-08 ZR-NOIP-5\A_check.cpp", "C++", 13, 0, 0, 0, 0, 7, 20
"d:\OI\Code\Comp\23-11-08 ZR-NOIP-5\B.cpp", "C++", 43, 0, 0, 0, 0, 20, 63
"d:\OI\Code\Comp\23-11-08 ZR-NOIP-5\D.cpp", "C++", 181, 0, 0, 0, 0, 69, 250
"d:\OI\Code\Comp\23-11-09 ZR-CSP-3\A.cpp", "C++", 67, 0, 0, 0, 0, 27, 94
"d:\OI\Code\Comp\23-11-09 ZR-CSP-3\D.cpp", "C++", 380, 0, 0, 0, 6, 86, 472
"d:\OI\Code\Comp\23-11-09 ZR-CSP-3\chb.md", "Markdown", 0, 0, 0, 4, 0, 2, 6
"d:\OI\Code\Comp\23-11-09 ZR-NOIP-6\A.cpp", "C++", 81, 0, 0, 0, 1, 24, 106
"d:\OI\Code\Comp\23-11-09 ZR-NOIP-6\B.cpp", "C++", 29, 0, 0, 0, 0, 12, 41
"d:\OI\Code\Comp\23-11-09 ZR-NOIP-6\C.cpp", "C++", 128, 0, 0, 0, 5, 46, 179
"d:\OI\Code\Comp\23-11-09 ZR-NOIP-6\D.cpp", "C++", 32, 0, 0, 0, 0, 19, 51
"d:\OI\Code\Comp\23-11-10 ZR-NOIP-7\A.cpp", "C++", 49, 0, 0, 0, 0, 24, 73
"d:\OI\Code\Comp\23-11-10 ZR-NOIP-7\B.cpp", "C++", 43, 0, 0, 0, 0, 17, 60
"d:\OI\Code\Comp\23-11-10 ZR-NOIP-7\C.cpp", "C++", 41, 0, 0, 0, 0, 18, 59
"d:\OI\Code\Comp\23-11-11 LGR-166\A.cpp", "C++", 10, 0, 0, 0, 0, 6, 16
"d:\OI\Code\Comp\23-11-18 NOIP-2023-VP\A.cpp", "C++", 115, 0, 0, 0, 5, 44, 164
"d:\OI\Code\Comp\23-11-18 NOIP-2023-VP\A_check.cpp", "C++", 17, 0, 0, 0, 0, 6, 23
"d:\OI\Code\Comp\23-11-18 NOIP-2023-VP\A_test.cpp", "C++", 14, 0, 0, 0, 0, 10, 24
"d:\OI\Code\Comp\23-11-18 NOIP-2023-VP\B.cpp", "C++", 96, 0, 0, 0, 0, 36, 132
"d:\OI\Code\Comp\23-11-18 NOIP-2023-VP\C.cpp", "C++", 36, 0, 0, 0, 0, 15, 51
"d:\OI\Code\Comp\23-11-18 NOIP-2023-VP\D.cpp", "C++", 50, 0, 0, 0, 0, 24, 74
"d:\OI\Code\Comp\24-02-03 Constructor-Open-Comp-2024\A.cpp", "C++", 12, 0, 0, 0, 0, 7, 19
"d:\OI\Code\Comp\24-02-03 Constructor-Open-Comp-2024\B.cpp", "C++", 15, 0, 0, 0, 0, 9, 24
"d:\OI\Code\Comp\24-02-03 Constructor-Open-Comp-2024\C.cpp", "C++", 19, 0, 0, 0, 0, 11, 30
"d:\OI\Code\Comp\24-02-03 Constructor-Open-Comp-2024\D.cpp", "C++", 18, 0, 0, 0, 0, 10, 28
"d:\OI\Code\Comp\24-02-03 Constructor-Open-Comp-2024\E.cpp", "C++", 25, 0, 0, 0, 0, 11, 36
"d:\OI\Code\Comp\24-02-03 Constructor-Open-Comp-2024\F.cpp", "C++", 24, 0, 0, 0, 0, 12, 36
"d:\OI\Code\Comp\24-02-03 Constructor-Open-Comp-2024\G.cpp", "C++", 23, 0, 0, 0, 0, 12, 35
"d:\OI\Code\Comp\24-02-03 Constructor-Open-Comp-2024\H.cpp", "C++", 16, 0, 0, 0, 14, 11, 41
"d:\OI\Code\Comp\24-02-06 CF923\A.cpp", "C++", 21, 0, 0, 0, 0, 9, 30
"d:\OI\Code\Comp\24-02-06 CF923\B.cpp", "C++", 24, 0, 0, 0, 0, 13, 37
"d:\OI\Code\Comp\24-02-06 CF923\C.cpp", "C++", 28, 0, 0, 0, 0, 13, 41
"d:\OI\Code\Comp\24-02-06 CF923\D.cpp", "C++", 53, 0, 0, 0, 0, 23, 76
"d:\OI\Code\Comp\24-02-10 ABC340\A.cpp", "C++", 11, 0, 0, 0, 0, 5, 16
"d:\OI\Code\Comp\24-02-10 ABC340\B.cpp", "C++", 16, 0, 0, 0, 0, 6, 22
"d:\OI\Code\Comp\24-02-10 ABC340\C.cpp", "C++", 14, 0, 0, 0, 0, 9, 23
"d:\OI\Code\Comp\24-02-10 ABC340\D.cpp", "C++", 56, 0, 0, 0, 0, 21, 77
"d:\OI\Code\Comp\24-02-10 ABC340\E.cpp", "C++", 33, 0, 0, 0, 1, 15, 49
"d:\OI\Code\Comp\24-02-15 ZOI-Round-1\A.cpp", "C++", 17, 0, 0, 0, 0, 7, 24
"d:\OI\Code\Comp\24-02-15 ZOI-Round-1\B.cpp", "C++", 30, 0, 0, 0, 1, 16, 47
"d:\OI\Code\Comp\24-02-15 ZOI-Round-1\C.cpp", "C++", 73, 0, 0, 0, 0, 25, 98
"d:\OI\Code\Comp\24-02-15 ZOI-Round-1\D.cpp", "C++", 5, 0, 0, 0, 1, 4, 10
"d:\OI\Code\Comp\24-02-17 ABC341\A.cpp", "C++", 7, 0, 0, 0, 0, 5, 12
"d:\OI\Code\Comp\24-02-17 ABC341\B.cpp", "C++", 18, 0, 0, 0, 1, 10, 29
"d:\OI\Code\Comp\24-02-17 ABC341\C.cpp", "C++", 39, 0, 0, 0, 0, 17, 56
"d:\OI\Code\Comp\24-02-17 ABC341\D.cpp", "C++", 70, 0, 0, 0, 0, 28, 98
"d:\OI\Code\Comp\24-02-18 CF927\A.cpp", "C++", 21, 0, 0, 0, 0, 12, 33
"d:\OI\Code\Comp\24-02-18 CF927\B.cpp", "C++", 19, 0, 0, 0, 0, 10, 29
"d:\OI\Code\Comp\24-02-18 CF927\C.cpp", "C++", 43, 0, 0, 0, 0, 22, 65
"d:\OI\Code\Comp\24-02-18 CF927\D.cpp", "C++", 78, 0, 0, 0, 0, 22, 100
"d:\OI\Code\Comp\24-02-19 LGR-174\A.cpp", "C++", 14, 0, 0, 0, 0, 9, 23
"d:\OI\Code\Comp\24-02-19 LGR-174\A_1.cpp", "C++", 22, 0, 0, 0, 0, 11, 33
"d:\OI\Code\Comp\24-02-19 LGR-174\B.cpp", "C++", 106, 0, 0, 0, 1, 35, 142
"d:\OI\Code\Comp\24-02-19 LGR-174\C.cpp", "C++", 42, 0, 0, 0, 0, 21, 63
"d:\OI\Code\Comp\24-02-19 LGR-174\D.cpp", "C++", 79, 0, 0, 0, 0, 30, 109
"d:\OI\Code\Comp\24-06-01 MXOI-pre\A_1.cpp", "C++", 95, 0, 0, 0, 5, 34, 134
"d:\OI\Code\Comp\24-06-01 MXOI-pre\A_2.cpp", "C++", 96, 0, 0, 0, 5, 35, 136
"d:\OI\Code\Comp\24-06-01 MXOI-pre\A_checker.cpp", "C++", 25, 0, 0, 0, 4, 13, 42
"d:\OI\Code\Comp\24-06-01 MXOI-pre\A_gen.cpp", "C++", 28, 0, 0, 0, 0, 12, 40
"d:\OI\Code\Comp\24-06-01 MXOI-pre\C_1.cpp", "C++", 146, 0, 0, 0, 6, 55, 207
"d:\OI\Code\Comp\24-06-01 MXOI-pre\C_2.cpp", "C++", 158, 0, 0, 0, 7, 59, 224
"d:\OI\Code\Comp\24-06-01 MXOI-pre\C_checker.cpp", "C++", 65, 0, 0, 0, 2, 27, 94
"d:\OI\Code\Comp\24-06-01 MXOI-pre\C_gen.cpp", "C++", 13, 0, 0, 0, 0, 6, 19
"d:\OI\Code\Comp\24-06-01 MXOI-pre\D_1.cpp", "C++", 72, 0, 0, 0, 1, 37, 110
"d:\OI\Code\Comp\24-06-01 MXOI-pre\D_2.cpp", "C++", 72, 0, 0, 0, 1, 37, 110
"d:\OI\Code\Comp\24-06-01 MXOI-pre\D_3.cpp", "C++", 76, 0, 0, 0, 1, 39, 116
"d:\OI\Code\Comp\24-06-01 MXOI-pre\D_checker.cpp", "C++", 27, 0, 0, 0, 2, 13, 42
"d:\OI\Code\Comp\24-06-01 MXOI-pre\D_gen.cpp", "C++", 17, 0, 0, 0, 0, 6, 23
"d:\OI\Code\Comp\24-06-01 MXOI-pre\test.cpp", "C++", 8, 0, 0, 0, 0, 4, 12
"d:\OI\Code\Comp\24-06-22 PJudege-J-6\A_1.cpp", "C++", 88, 0, 0, 0, 0, 18, 106
"d:\OI\Code\Comp\24-06-22 PJudege-J-6\A_gen.cpp", "C++", 4, 0, 0, 0, 0, 2, 6
"d:\OI\Code\Comp\24-06-22 PJudege-J-6\B.cpp", "C++", 39, 0, 0, 0, 2, 15, 56
"d:\OI\Code\Comp\24-06-22 PJudege-J-6\C.cpp", "C++", 20, 0, 0, 0, 2, 11, 33
"d:\OI\Code\Comp\24-06-29 MX-Weekly-S\A.cpp", "C++", 51, 0, 0, 0, 2, 25, 78
"d:\OI\Code\Comp\24-06-29 MX-Weekly-S\A_2.cpp", "C++", 39, 0, 0, 0, 1, 18, 58
"d:\OI\Code\Comp\24-06-29 MX-Weekly-S\A_3.cpp", "C++", 36, 0, 0, 0, 0, 16, 52
"d:\OI\Code\Comp\24-06-29 MX-Weekly-S\A_checker.cpp", "C++", 18, 0, 0, 0, 0, 13, 31
"d:\OI\Code\Comp\24-06-29 MX-Weekly-S\A_gen.cpp", "C++", 13, 0, 0, 0, 0, 7, 20
"d:\OI\Code\Comp\24-06-29 MX-Weekly-S\A_pai.cpp", "C++", 13, 0, 0, 0, 0, 7, 20
"d:\OI\Code\Comp\24-06-29 MX-Weekly-S\B.cpp", "C++", 68, 0, 0, 0, 21, 27, 116
"d:\OI\Code\Comp\24-06-29 MX-Weekly-S\B_1.cpp", "C++", 54, 0, 0, 0, 0, 19, 73
"d:\OI\Code\Comp\24-06-29 MX-Weekly-S\B_2.cpp", "C++", 30, 0, 0, 0, 0, 11, 41
"d:\OI\Code\Comp\24-06-29 MX-Weekly-S\B_gen.cpp", "C++", 45, 0, 0, 0, 0, 15, 60
"d:\OI\Code\Comp\24-06-29 MX-Weekly-S\B_pai.cpp", "C++", 13, 0, 0, 0, 0, 5, 18
"d:\OI\Code\Comp\24-07-05 Beta\A.cpp", "C++", 10, 0, 0, 0, 0, 4, 14
"d:\OI\Code\Comp\24-07-05 Beta\C.cpp", "C++", 17, 0, 0, 0, 0, 10, 27
"d:\OI\Code\Comp\24-07-05 Beta\D.cpp", "C++", 27, 0, 0, 0, 4, 13, 44
"d:\OI\Code\Comp\24-07-05 Beta\E.cpp", "C++", 66, 0, 0, 0, 0, 28, 94
"d:\OI\Code\Comp\24-07-05 Beta\E_2.cpp", "C++", 30, 0, 0, 0, 0, 18, 48
"d:\OI\Code\Comp\24-07-05 Beta\E_3.cpp", "C++", 46, 0, 0, 0, 0, 23, 69
"d:\OI\Code\Comp\24-07-05 Beta\E_4.cpp", "C++", 90, 0, 0, 0, 3, 39, 132
"d:\OI\Code\Comp\24-07-05 Beta\E_gen.cpp", "C++", 11, 0, 0, 0, 0, 5, 16
"d:\OI\Code\Comp\24-07-10 MX-13-1\A.cpp", "C++", 35, 0, 0, 0, 0, 15, 50
"d:\OI\Code\Comp\24-07-10 MX-13-1\A_2.cpp", "C++", 9, 0, 0, 0, 2, 7, 18
"d:\OI\Code\Comp\24-07-10 MX-13-1\A_3.cpp", "C++", 59, 0, 0, 0, 0, 20, 79
"d:\OI\Code\Comp\24-07-10 MX-13-1\After\A.cpp", "C++", 44, 0, 0, 0, 0, 21, 65
"d:\OI\Code\Comp\24-07-10 MX-13-1\B_1.cpp", "C++", 16, 0, 0, 0, 0, 9, 25
"d:\OI\Code\Comp\24-07-10 MX-13-1\C.cpp", "C++", 36, 0, 0, 0, 0, 12, 48
"d:\OI\Code\Comp\24-07-11 CF957\A.cpp", "C++", 22, 0, 0, 0, 0, 11, 33
"d:\OI\Code\Comp\24-07-11 CF957\B.cpp", "C++", 18, 0, 0, 0, 0, 8, 26
"d:\OI\Code\Comp\24-07-11 CF957\C.cpp", "C++", 16, 0, 0, 0, 0, 11, 27
"d:\OI\Code\Comp\24-07-11 CF957\D.cpp", "C++", 44, 0, 0, 0, 0, 20, 64
"d:\OI\Code\Comp\24-07-11 CF957\E.cpp", "C++", 14, 0, 0, 0, 0, 7, 21
"d:\OI\Code\Comp\24-07-13 LGR193\A.cpp", "C++", 26, 0, 0, 0, 0, 15, 41
"d:\OI\Code\Comp\24-07-13 LGR193\B.cpp", "C++", 38, 0, 0, 0, 0, 17, 55
"d:\OI\Code\Comp\24-07-13 LGR193\C.cpp", "C++", 75, 0, 0, 0, 0, 25, 100
"d:\OI\Code\Comp\24-07-14 MX-13-2\A.cpp", "C++", 24, 0, 0, 0, 2, 11, 37
"d:\OI\Code\Comp\24-07-14 MX-13-2\A_1.cpp", "C++", 48, 0, 0, 0, 0, 17, 65
"d:\OI\Code\Comp\24-07-14 MX-13-2\A_gen.cpp", "C++", 14, 0, 0, 0, 0, 7, 21
"d:\OI\Code\Comp\24-07-14 MX-13-2\A_pai.cpp", "C++", 16, 0, 0, 0, 0, 7, 23
"d:\OI\Code\Comp\24-07-14 MX-13-2\After\B.cpp", "C++", 68, 0, 0, 0, 0, 32, 100
"d:\OI\Code\Comp\24-07-14 MX-13-2\After\B_0.cpp", "C++", 66, 0, 0, 0, 10, 34, 110
"d:\OI\Code\Comp\24-07-14 MX-13-2\After\D.cpp", "C++", 53, 0, 0, 0, 0, 24, 77
"d:\OI\Code\Comp\24-07-14 MX-13-2\B.cpp", "C++", 66, 0, 0, 0, 0, 30, 96
"d:\OI\Code\Comp\24-07-14 MX-13-2\B_1.cpp", "C++", 106, 0, 0, 0, 1, 47, 154
"d:\OI\Code\Comp\24-07-14 MX-13-2\C.cpp", "C++", 51, 0, 0, 0, 0, 25, 76
"d:\OI\Code\Comp\24-07-16 MX\A.cpp", "C++", 93, 0, 0, 0, 1, 27, 121
"d:\OI\Code\Comp\24-07-16 MX\After\A.cpp", "C++", 81, 0, 0, 0, 0, 17, 98
"d:\OI\Code\Comp\24-07-16 MX\After\A_std.cpp", "C++", 47, 0, 0, 0, 2, 2, 51
"d:\OI\Code\Comp\24-07-16 MX\After\B.cpp", "C++", 24, 0, 0, 0, 0, 14, 38
"d:\OI\Code\Comp\24-07-16 MX\B.cpp", "C++", 53, 0, 0, 0, 0, 21, 74
"d:\OI\Code\Comp\24-07-16 MX\B_1.cpp", "C++", 55, 0, 0, 0, 1, 23, 79
"d:\OI\Code\Comp\24-07-16 MX\B_gen.cpp", "C++", 21, 0, 0, 0, 16, 14, 51
"d:\OI\Code\Comp\24-07-16 MX\B_pai.cpp", "C++", 15, 0, 0, 0, 0, 7, 22
"d:\OI\Code\Comp\24-07-16 MX\C.cpp", "C++", 41, 0, 0, 0, 0, 14, 55
"d:\OI\Code\Comp\24-07-16 MX\D.cpp", "C++", 35, 0, 0, 0, 0, 15, 50
"d:\OI\Code\Comp\24-07-18 MX\A.cpp", "C++", 70, 0, 0, 0, 0, 27, 97
"d:\OI\Code\Comp\24-07-18 MX\A_1.cpp", "C++", 48, 0, 0, 0, 0, 21, 69
"d:\OI\Code\Comp\24-07-18 MX\A_2.cpp", "C++", 105, 0, 0, 0, 1, 38, 144
"d:\OI\Code\Comp\24-07-18 MX\A_test.cpp", "C++", 5, 0, 0, 0, 0, 3, 8
"d:\OI\Code\Comp\24-07-18 MX\After\C.cpp", "C++", 56, 0, 0, 0, 0, 22, 78
"d:\OI\Code\Comp\24-07-18 MX\C.cpp", "C++", 75, 0, 0, 0, 1, 29, 105
"d:\OI\Code\Comp\24-07-18 MX\D.cpp", "C++", 11, 0, 0, 0, 0, 8, 19
"d:\OI\Code\Comp\24-07-20 ABC363\A.cpp", "C++", 15, 0, 0, 0, 0, 7, 22
"d:\OI\Code\Comp\24-07-20 ABC363\B.cpp", "C++", 18, 0, 0, 0, 0, 10, 28
"d:\OI\Code\Comp\24-07-20 ABC363\C.cpp", "C++", 39, 0, 0, 0, 0, 20, 59
"d:\OI\Code\Comp\24-07-20 ABC363\D.cpp", "C++", 38, 0, 0, 0, 0, 17, 55
"d:\OI\Code\Comp\24-07-20 CF960\A.cpp", "C++", 24, 0, 0, 0, 0, 13, 37
"d:\OI\Code\Comp\24-07-20 CF960\B.cpp", "C++", 18, 0, 0, 0, 0, 10, 28
"d:\OI\Code\Comp\24-07-20 CF960\C.cpp", "C++", 43, 0, 0, 0, 0, 21, 64
"d:\OI\Code\Comp\24-07-20 CF960\D.cpp", "C++", 22, 0, 0, 0, 0, 12, 34
"d:\OI\Code\Comp\24-07-20 MX\A.cpp", "C++", 74, 0, 0, 0, 4, 37, 115
"d:\OI\Code\Comp\24-07-20 MX\B.cpp", "C++", 55, 0, 0, 0, 0, 24, 79
"d:\OI\Code\Comp\24-07-20 MX\B_1.cpp", "C++", 51, 0, 0, 0, 2, 23, 76
"d:\OI\Code\Comp\24-07-20 MX\C.cpp", "C++", 99, 0, 0, 0, 0, 38, 137
"d:\OI\Code\Comp\24-07-20 MX\D.cpp", "C++", 40, 0, 0, 0, 0, 14, 54
"d:\OI\Code\Comp\24-07-22 MX\A.cpp", "C++", 19, 0, 0, 0, 0, 11, 30
"d:\OI\Code\Comp\24-07-22 MX\A_1.cpp", "C++", 45, 0, 0, 0, 11, 26, 82
"d:\OI\Code\Comp\24-07-22 MX\A_table.cpp", "C++", 19, 0, 0, 0, 0, 11, 30
"d:\OI\Code\Comp\24-07-22 MX\After\A.cpp", "C++", 19, 0, 0, 0, 0, 12, 31
"d:\OI\Code\Comp\24-07-22 MX\After\B.cpp", "C++", 44, 0, 0, 0, 0, 18, 62
"d:\OI\Code\Comp\24-07-22 MX\B.cpp", "C++", 28, 0, 0, 0, 0, 12, 40
"d:\OI\Code\Comp\24-07-22 MX\C.cpp", "C++", 73, 0, 0, 0, 0, 34, 107
"d:\OI\Code\Comp\24-07-22 MX\C_test.cpp", "C++", 2808, 0, 0, 0, 0, 4, 2812
"d:\OI\Code\Comp\24-07-22 MX\D.cpp", "C++", 18, 0, 0, 0, 0, 10, 28
"d:\OI\Code\Comp\24-07-23 MX\A.cpp", "C++", 50, 0, 0, 0, 0, 20, 70
"d:\OI\Code\Comp\24-07-23 MX\B.cpp", "C++", 4, 0, 0, 0, 0, 3, 7
"d:\OI\Code\Comp\24-07-23 MX\C.cpp", "C++", 50, 0, 0, 0, 0, 18, 68
"d:\OI\Code\Comp\24-07-23 MX\F.cpp", "C++", 80, 0, 0, 0, 0, 33, 113
"d:\OI\Code\Comp\24-07-23 MX\F_1.cpp", "C++", 72, 0, 0, 0, 0, 29, 101
"d:\OI\Code\Comp\24-07-24 MX\A.cpp", "C++", 116, 0, 0, 0, 0, 42, 158
"d:\OI\Code\Comp\24-07-24 MX\A_1.cpp", "C++", 22, 0, 0, 0, 0, 10, 32
"d:\OI\Code\Comp\24-07-24 MX\B.cpp", "C++", 58, 0, 0, 0, 4, 28, 90
"d:\OI\Code\Comp\24-07-24 MX\C.cpp", "C++", 30, 0, 0, 0, 0, 11, 41
"d:\OI\Code\Comp\24-07-24 MX\D.cpp", "C++", 22, 0, 0, 0, 2, 14, 38
"d:\OI\Code\Comp\24-07-25 MX\A.cpp", "C++", 38, 0, 0, 0, 0, 18, 56
"d:\OI\Code\Comp\24-07-25 MX\C.cpp", "C++", 28, 0, 0, 0, 1, 13, 42
"d:\OI\Code\Comp\24-07-25 MX\D.cpp", "C++", 26, 0, 0, 0, 0, 12, 38
"d:\OI\Code\Comp\24-07-25 MX\E.cpp", "C++", 21, 0, 0, 0, 0, 12, 33
"d:\OI\Code\Comp\24-07-26 MX\A.cpp", "C++", 18, 0, 0, 0, 0, 11, 29
"d:\OI\Code\Comp\24-07-26 MX\B.cpp", "C++", 37, 0, 0, 0, 0, 15, 52
"d:\OI\Code\Comp\24-07-26 MX\C.cpp", "C++", 186, 0, 0, 0, 0, 63, 249
"d:\OI\Code\Comp\24-07-26 MX\C_1.cpp", "C++", 45, 0, 0, 0, 0, 22, 67
"d:\OI\Code\Comp\24-07-26 MX\D.cpp", "C++", 33, 0, 0, 0, 0, 11, 44
"d:\OI\Code\Comp\24-07-27 ABC364\A.cpp", "C++", 17, 0, 0, 0, 0, 6, 23
"d:\OI\Code\Comp\24-07-27 ABC364\B.cpp", "C++", 35, 0, 0, 0, 0, 13, 48
"d:\OI\Code\Comp\24-07-27 ABC364\C.cpp", "C++", 40, 0, 0, 0, 0, 18, 58
"d:\OI\Code\Comp\24-07-27 ABC364\D.cpp", "C++", 52, 0, 0, 0, 0, 24, 76
"d:\OI\Code\Comp\24-07-27 ABC364\E.cpp", "C++", 29, 0, 0, 0, 0, 12, 41
"d:\OI\Code\Comp\24-07-27 MX\A.cpp", "C++", 28, 0, 0, 0, 0, 14, 42
"d:\OI\Code\Comp\24-07-27 MX\B.cpp", "C++", 33, 0, 0, 0, 0, 15, 48
"d:\OI\Code\Comp\24-07-27 MX\B_1.cpp", "C++", 38, 0, 0, 0, 0, 15, 53
"d:\OI\Code\Comp\24-07-27 MX\C.cpp", "C++", 61, 0, 0, 0, 0, 19, 80
"d:\OI\Code\Comp\24-07-27 MX\C_1.cpp", "C++", 51, 0, 0, 0, 0, 15, 66
"d:\OI\Code\Comp\24-07-28 MX-13-3\A.cpp", "C++", 48, 0, 0, 0, 9, 24, 81
"d:\OI\Code\Comp\24-07-28 MX-13-3\B.cpp", "C++", 4, 0, 0, 0, 0, 5, 9
"d:\OI\Code\Comp\24-07-29 MX\A.cpp", "C++", 67, 0, 0, 0, 0, 26, 93
"d:\OI\Code\Comp\24-07-29 MX\B.cpp", "C++", 19, 0, 0, 0, 0, 10, 29
"d:\OI\Code\Comp\24-07-29 MX\D.cpp", "C++", 104, 0, 0, 0, 4, 38, 146
"d:\OI\Code\Comp\24-07-30 MX\A.cpp", "C++", 47, 0, 0, 0, 0, 17, 64
"d:\OI\Code\Comp\24-07-30 MX\B.cpp", "C++", 41, 0, 0, 0, 0, 16, 57
"d:\OI\Code\Comp\24-07-30 MX\F.cpp", "C++", 41, 0, 0, 0, 0, 17, 58
"d:\OI\Code\Comp\24-07-30 MX\test.cpp", "C++", 10, 0, 0, 0, 0, 4, 14
"d:\OI\Code\Comp\24-07-31 MX\A.cpp", "C++", 25, 0, 0, 0, 0, 11, 36
"d:\OI\Code\Comp\24-07-31 MX\A_1.cpp", "C++", 52, 0, 0, 0, 0, 16, 68
"d:\OI\Code\Comp\24-07-31 MX\A_2.cpp", "C++", 23, 0, 0, 0, 0, 9, 32
"d:\OI\Code\Comp\24-07-31 MX\A_3.cpp", "C++", 45, 0, 0, 0, 7, 16, 68
"d:\OI\Code\Comp\24-07-31 MX\After\A.cpp", "C++", 35, 0, 0, 0, 4, 17, 56
"d:\OI\Code\Comp\24-07-31 MX\After\B.cpp", "C++", 8, 0, 0, 0, 0, 6, 14
"d:\OI\Code\Comp\24-07-31 MX\After\test.cpp", "C++", 10, 0, 0, 0, 0, 5, 15
"d:\OI\Code\Comp\24-07-31 MX\B.cpp", "C++", 47, 0, 0, 0, 0, 17, 64
"d:\OI\Code\Comp\24-07-31 MX\C.cpp", "C++", 34, 0, 0, 0, 0, 13, 47
"d:\OI\Code\Comp\24-07-31 MX\D.cpp", "C++", 26, 0, 0, 0, 0, 11, 37
"d:\OI\Code\Comp\24-08-01 MX\A.cpp", "C++", 78, 0, 0, 0, 0, 29, 107
"d:\OI\Code\Comp\24-08-01 MX\After\B.cpp", "C++", 38, 0, 0, 0, 0, 16, 54
"d:\OI\Code\Comp\24-08-01 MX\After\C.cpp", "C++", 72, 0, 0, 0, 1, 25, 98
"d:\OI\Code\Comp\24-08-01 MX\B.cpp", "C++", 5, 0, 0, 0, 0, 3, 8
"d:\OI\Code\Comp\24-08-01 MX\G.cpp", "C++", 79, 0, 0, 0, 0, 25, 104
"d:\OI\Code\Comp\24-08-01 MX\G_xhr.cpp", "C++", 113, 0, 0, 0, 6, 0, 119
"d:\OI\Code\Comp\24-08-02 MX\A.cpp", "C++", 96, 0, 0, 0, 9, 42, 147
"d:\OI\Code\Comp\24-08-02 MX\B.cpp", "C++", 67, 0, 0, 0, 5, 25, 97
"d:\OI\Code\Comp\24-08-03 ABC365\A.cpp", "C++", 14, 0, 0, 0, 0, 4, 18
"d:\OI\Code\Comp\24-08-03 ABC365\B.cpp", "C++", 17, 0, 0, 0, 0, 9, 26
"d:\OI\Code\Comp\24-08-03 ABC365\C.cpp", "C++", 26, 0, 0, 0, 0, 12, 38
"d:\OI\Code\Comp\24-08-03 ABC365\D.cpp", "C++", 30, 0, 0, 0, 0, 8, 38
"d:\OI\Code\Comp\24-08-03 ABC365\D_1.cpp", "C++", 8, 0, 0, 0, 0, 6, 14
"d:\OI\Code\Comp\24-08-03 ABC365\E.cpp", "C++", 50, 0, 0, 0, 0, 17, 67
"d:\OI\Code\Comp\24-08-03 MX\A.cpp", "C++", 36, 0, 0, 0, 0, 13, 49
"d:\OI\Code\Comp\24-08-03 MX\B.cpp", "C++", 34, 0, 0, 0, 0, 13, 47
"d:\OI\Code\Comp\24-08-03 MX\B_1.cpp", "C++", 28, 0, 0, 0, 0, 8, 36
"d:\OI\Code\Comp\24-08-03 MX\D.cpp", "C++", 23, 0, 0, 0, 0, 8, 31
"d:\OI\Code\Comp\24-08-04 MX-J-2\A.cpp", "C++", 21, 0, 0, 0, 0, 9, 30
"d:\OI\Code\Comp\24-08-04 MX-J-2\B.cpp", "C++", 13, 0, 0, 0, 0, 7, 20
"d:\OI\Code\Comp\24-08-04 MX-J-2\C.cpp", "C++", 25, 0, 0, 0, 0, 10, 35
"d:\OI\Code\Comp\24-08-04 MX-J-2\D.cpp", "C++", 77, 0, 0, 0, 0, 23, 100
"d:\OI\Code\Comp\24-08-05 MX\A.cpp", "C++", 50, 0, 0, 0, 0, 20, 70
"d:\OI\Code\Comp\24-08-05 MX\A_xhr.cpp", "C++", 63, 0, 0, 0, 7, 5, 75
"d:\OI\Code\Comp\24-08-05 MX\B.cpp", "C++", 108, 0, 0, 0, 1, 36, 145
"d:\OI\Code\Comp\24-08-05 MX\D.cpp", "C++", 17, 0, 0, 0, 0, 8, 25
"d:\OI\Code\Comp\24-08-06 MX\A.cpp", "C++", 24, 0, 0, 0, 0, 13, 37
"d:\OI\Code\Comp\24-08-06 MX\B.cpp", "C++", 26, 0, 0, 0, 0, 15, 41
"d:\OI\Code\Comp\24-08-06 MX\B_1.cpp", "C++", 31, 0, 0, 0, 0, 13, 44
"d:\OI\Code\Comp\24-08-06 MX\C.cpp", "C++", 17, 0, 0, 0, 0, 10, 27
"d:\OI\Code\Comp\24-08-06 MX\C_1.cpp", "C++", 39, 0, 0, 0, 0, 16, 55
"d:\OI\Code\Comp\24-08-07 MX\A.cpp", "C++", 31, 0, 0, 0, 0, 14, 45
"d:\OI\Code\Comp\24-08-07 MX\After\C.cpp", "C++", 74, 0, 0, 0, 0, 27, 101
"d:\OI\Code\Comp\24-08-07 MX\B.cpp", "C++", 76, 0, 0, 0, 0, 27, 103
"d:\OI\Code\Comp\24-08-07 MX\C.cpp", "C++", 37, 0, 0, 0, 0, 17, 54
"d:\OI\Code\Comp\24-08-08 MX\A.cpp", "C++", 51, 0, 0, 0, 0, 23, 74
"d:\OI\Code\Comp\24-08-08 MX\B.cpp", "C++", 38, 0, 0, 0, 0, 15, 53
"d:\OI\Code\Comp\24-08-09 MX\A.cpp", "C++", 33, 0, 0, 0, 0, 13, 46
"d:\OI\Code\Comp\24-08-09 MX\A_1.cpp", "C++", 31, 0, 0, 0, 0, 12, 43
"d:\OI\Code\Comp\24-08-09 MX\B.cpp", "C++", 79, 0, 0, 0, 2, 21, 102
"d:\OI\Code\Comp\24-08-10 ABC\A.cpp", "C++", 9, 0, 0, 0, 0, 5, 14
"d:\OI\Code\Comp\24-08-10 ABC\B.cpp", "C++", 32, 0, 0, 0, 0, 11, 43
"d:\OI\Code\Comp\24-08-10 CF1998\A.cpp", "C++", 20, 0, 0, 0, 0, 11, 31
"d:\OI\Code\Comp\24-08-10 MX-X2\A.cpp", "C++", 39, 0, 0, 0, 0, 16, 55
"d:\OI\Code\Comp\24-08-10 MX-X2\A_1.cpp", "C++", 6, 0, 0, 0, 0, 3, 9
"d:\OI\Code\Comp\24-08-10 MX-X2\B.cpp", "C++", 20, 0, 0, 0, 0, 10, 30
"d:\OI\Code\Comp\24-08-10 MX-X2\B_1.cpp", "C++", 35, 0, 0, 0, 0, 16, 51
"d:\OI\Code\Comp\24-08-10 MX-X2\C.cpp", "C++", 25, 0, 0, 0, 0, 11, 36
"d:\OI\Code\Comp\24-08-10 MX-X2\C_1.cpp", "C++", 12, 0, 0, 0, 0, 8, 20
"d:\OI\Code\Comp\24-08-10 MX-X2\D.cpp", "C++", 35, 0, 0, 0, 0, 12, 47
"d:\OI\Code\Comp\24-08-10 MX-X2\E.cpp", "C++", 36, 0, 0, 0, 0, 16, 52
"d:\OI\Code\Comp\24-08-12 MX\A.cpp", "C++", 26, 0, 0, 0, 0, 8, 34
"d:\OI\Code\Comp\24-08-12 MX\A_1.cpp", "C++", 70, 0, 0, 0, 0, 27, 97
"d:\OI\Code\Comp\24-08-12 MX\B.cpp", "C++", 0, 0, 0, 0, 0, 1, 1
"d:\OI\Code\Comp\24-08-12 MX\B\sol.cpp", "C++", 0, 0, 0, 0, 0, 1, 1
"d:\OI\Code\Comp\24-08-12 MX\C.cpp", "C++", 26, 0, 0, 0, 0, 8, 34
"d:\OI\Code\Comp\24-08-12 test\A.cpp", "C++", 26, 0, 0, 0, 0, 8, 34
"d:\OI\Code\Comp\24-08-12 test\finihs.cpp", "C++", 26, 0, 0, 0, 0, 8, 34
"d:\OI\Code\Comp\24-08-13 ABC300-vp\A.cpp", "C++", 35, 0, 0, 0, 0, 11, 46
"d:\OI\Code\Comp\24-08-13 ABC300-vp\B.cpp", "C++", 52, 0, 0, 0, 0, 17, 69
"d:\OI\Code\Comp\24-08-13 ABC300-vp\C.cpp", "C++", 53, 0, 0, 0, 0, 18, 71
"d:\OI\Code\Comp\24-08-13 ABC300-vp\D.cpp", "C++", 60, 0, 0, 0, 0, 20, 80
"d:\OI\Code\Comp\24-08-13 ABC300-vp\E.cpp", "C++", 51, 0, 0, 0, 0, 20, 71
"d:\OI\Code\Comp\24-08-13 ABC300-vp\F.cpp", "C++", 49, 0, 0, 0, 0, 20, 69
"d:\OI\Code\Comp\24-08-13 ABC300-vp\G.cpp", "C++", 43, 0, 0, 0, 0, 16, 59
"d:\OI\Code\Comp\24-08-13 CF996\A.cpp", "C++", 47, 0, 0, 0, 0, 15, 62
"d:\OI\Code\Comp\24-08-13 CF996\B.cpp", "C++", 49, 0, 0, 0, 0, 18, 67
"d:\OI\Code\Comp\24-08-13 CF996\C.cpp", "C++", 60, 0, 0, 0, 0, 21, 81
"d:\OI\Code\Comp\24-08-13 CF996\D.cpp", "C++", 52, 0, 0, 0, 0, 19, 71
"d:\OI\Code\Comp\24-08-13 CF996\E.cpp", "C++", 51, 0, 0, 0, 16, 17, 84
"d:\OI\Code\Comp\24-08-13 CF996\E_1.cpp", "C++", 75, 0, 0, 0, 0, 24, 99
"d:\OI\Code\Comp\24-08-13 CF996\F.cpp", "C++", 39, 0, 0, 0, 0, 15, 54
"d:\OI\Code\Comp\24-08-17 MX-S3\A.cpp", "C++", 100, 0, 0, 0, 3, 38, 141
"d:\OI\Code\Comp\24-08-17 MX-S3\A_1.cpp", "C++", 97, 0, 0, 0, 0, 38, 135
"d:\OI\Code\Comp\24-08-17 MX-S3\B.cpp", "C++", 106, 0, 0, 0, 0, 33, 139
"d:\OI\Code\Comp\24-08-17 MX-S3\B_1.cpp", "C++", 38, 0, 0, 0, 0, 13, 51
"d:\OI\Code\Comp\24-08-17 MX-S3\B_2.cpp", "C++", 31, 0, 0, 0, 0, 9, 40
"d:\OI\Code\Comp\24-08-17 MX-S3\luogu.cpp", "C++", 53, 0, 0, 0, 2, 14, 69
"d:\OI\Code\Comp\24-08-18 MX-NOIP-6\A.cpp", "C++", 67, 0, 0, 0, 3, 27, 97
"d:\OI\Code\Comp\24-08-18 MX-NOIP-6\A_gen.cpp", "C++", 43, 0, 0, 0, 1, 14, 58
"d:\OI\Code\Comp\24-08-18 MX-NOIP-6\A_pai.cpp", "C++", 42, 0, 0, 0, 1, 14, 57
"d:\OI\Code\Comp\24-08-18 MX-NOIP-6\A_task0.cpp", "C++", 55, 0, 0, 0, 1, 20, 76
"d:\OI\Code\Comp\24-08-18 MX-NOIP-6\B.cpp", "C++", 105, 0, 0, 0, 1, 34, 140
"d:\OI\Code\Comp\24-08-18 MX-NOIP-6\C.cpp", "C++", 138, 0, 0, 0, 1, 47, 186
"d:\OI\Code\Comp\24-08-18 MX-NOIP-6\D.cpp", "C++", 69, 0, 0, 0, 1, 20, 90
"d:\OI\Code\Comp\24-08-22 ABC362-vp\A.cpp", "C++", 40, 0, 0, 0, 1, 12, 53
"d:\OI\Code\Comp\24-08-22 ABC362-vp\ABC363D.cpp", "C++", 39, 0, 0, 0, 1, 12, 52
"d:\OI\Code\Comp\24-08-22 ABC362-vp\B.cpp", "C++", 42, 0, 0, 0, 1, 13, 56
"d:\OI\Code\Comp\24-08-22 ABC362-vp\C.cpp", "C++", 51, 0, 0, 0, 1, 17, 69
"d:\OI\Code\Comp\24-08-22 ABC362-vp\D.cpp", "C++", 84, 0, 0, 0, 1, 26, 111
"d:\OI\Code\Comp\24-08-22 ABC362-vp\E.cpp", "C++", 70, 0, 0, 0, 1, 21, 92
"d:\OI\Code\Comp\24-08-22 ABC362-vp\F.cpp", "C++", 103, 0, 0, 0, 1, 29, 133
"d:\OI\Code\Comp\24-08-24 ABC361-vp\A.cpp", "C++", 44, 0, 0, 0, 1, 14, 59
"d:\OI\Code\Comp\24-08-24 ABC361-vp\B.cpp", "C++", 97, 0, 0, 0, 1, 26, 124
"d:\OI\Code\Comp\24-08-24 ABC361-vp\C.cpp", "C++", 52, 0, 0, 0, 1, 21, 74
"d:\OI\Code\Comp\24-08-24 ABC361-vp\D.cpp", "C++", 68, 0, 0, 0, 1, 23, 92
"d:\OI\Code\Comp\24-08-24 ABC361-vp\D_1.cpp", "C++", 43, 0, 0, 0, 1, 13, 57
"d:\OI\Code\Comp\24-08-24 ABC361-vp\E.cpp", "C++", 72, 0, 0, 0, 1, 22, 95
"d:\OI\Code\Comp\24-08-24 ABC361-vp\F.cpp", "C++", 88, 0, 0, 0, 1, 20, 109
"d:\OI\Code\Comp\24-08-25 MX-NOIP-7\A.cpp", "C++", 88, 0, 0, 0, 2, 27, 117
"d:\OI\Code\Comp\24-08-25 MX-NOIP-7\B.cpp", "C++", 146, 0, 0, 0, 1, 43, 190
"d:\OI\Code\Comp\24-08-25 MX-NOIP-7\D.cpp", "C++", 67, 0, 0, 0, 1, 22, 90
"d:\OI\Code\Comp\24-08-31 MX\A.cpp", "C++", 62, 0, 0, 0, 3, 19, 84
"d:\OI\Code\Comp\24-08-31 MX\After\B.cpp", "C++", 86, 0, 0, 0, 14, 29, 129
"d:\OI\Code\Comp\24-08-31 MX\B.cpp", "C++", 92, 0, 0, 0, 13, 32, 137
"d:\OI\Code\Comp\24-08-31 MX\C.cpp", "C++", 105, 0, 0, 0, 4, 30, 139
"d:\OI\Code\Comp\24-08-31 MX\D.cpp", "C++", 54, 0, 0, 0, 3, 17, 74
"d:\OI\Code\Comp\24-09-07 MX-NOIP-8\A.cpp", "C++", 102, 0, 0, 0, 10, 34, 146
"d:\OI\Code\Comp\24-09-07 MX-NOIP-8\After\B.cpp", "C++", 126, 0, 0, 0, 17, 43, 186
"d:\OI\Code\Comp\24-09-07 MX-NOIP-8\B.cpp", "C++", 208, 0, 0, 0, 14, 71, 293
"d:\OI\Code\Comp\24-09-07 MX-NOIP-8\B_0.cpp", "C++", 30, 0, 0, 0, 3, 14, 47
"d:\OI\Code\Comp\24-09-07 MX-NOIP-8\B_1.cpp", "C++", 23, 0, 0, 0, 3, 11, 37
"d:\OI\Code\Comp\24-09-07 MX-NOIP-8\B_STD.cpp", "C++", 53, 0, 0, 0, 17, 15, 85
"d:\OI\Code\Comp\24-09-07 MX-NOIP-8\B_gen.cpp", "C++", 32, 0, 0, 0, 3, 15, 50
"d:\OI\Code\Comp\24-09-07 MX-NOIP-8\B_pai.cpp", "C++", 30, 0, 0, 0, 4, 12, 46
"d:\OI\Code\Comp\24-09-07 MX-NOIP-8\C.cpp", "C++", 97, 0, 0, 0, 7, 39, 143
"d:\OI\Code\Comp\24-09-07 MX-NOIP-8\D.cpp", "C++", 40, 0, 0, 0, 3, 16, 59
"d:\OI\Code\Comp\24-09-08 MX\B.cpp", "C++", 92, 0, 0, 0, 3, 29, 124
"d:\OI\Code\Comp\24-09-08 MX\a.cpp", "C++", 77, 0, 0, 0, 8, 33, 118
"d:\OI\Code\Comp\24-09-11 MX\A.cpp", "C++", 120, 0, 0, 0, 5, 31, 156
"d:\OI\Code\Comp\24-09-11 MX\After\A.cpp", "C++", 75, 0, 0, 0, 3, 23, 101
"d:\OI\Code\Comp\24-09-11 MX\After\B.cpp", "C++", 80, 0, 0, 0, 3, 29, 112
"d:\OI\Code\Comp\24-09-11 MX\After\B_删除序列.cpp", "C++", 23, 0, 0, 0, 3, 11, 37
"d:\OI\Code\Comp\24-09-11 MX\B.cpp", "C++", 150, 0, 0, 0, 14, 50, 214
"d:\OI\Code\Comp\24-09-14 MX\A-swap-cpp-.cpp", "C++", 77, 0, 0, 0, 4, 30, 111
"d:\OI\Code\Comp\24-09-14 MX\A1.cpp", "C++", 116, 0, 0, 0, 4, 37, 157
"d:\OI\Code\Comp\24-09-14 MX\C-room-cpp-.cpp", "C++", 75, 0, 0, 0, 3, 22, 100
"d:\OI\Code\Comp\24-09-15 ABC371-vp\A-Jiro.cpp", "C++", 30, 0, 0, 0, 3, 13, 46
"d:\OI\Code\Comp\24-09-15 ABC371-vp\B-Taro.cpp", "C++", 33, 0, 0, 0, 3, 13, 49
"d:\OI\Code\Comp\24-09-15 ABC371-vp\C-Make-Isomorphic.cpp", "C++", 50, 0, 0, 0, 3, 23, 76
"d:\OI\Code\Comp\24-09-15 ABC371-vp\D-1D-Country.cpp", "C++", 40, 0, 0, 0, 3, 19, 62
"d:\OI\Code\Comp\24-09-15 ABC371-vp\E-I-Hate-Sigma-Problems.cpp", "C++", 39, 0, 0, 0, 3, 17, 59
"d:\OI\Code\Comp\24-09-15 MX\A.cpp", "C++", 92, 0, 0, 0, 40, 39, 171
"d:\OI\Code\Comp\24-09-15 MX\B-.cpp", "C++", 103, 0, 0, 0, 3, 23, 129
"d:\OI\Code\Comp\24-09-15 MX\C-.cpp", "C++", 62, 0, 0, 0, 3, 21, 86
"d:\OI\Code\Comp\24-09-16 MX\T510090-MX-X4-T2-Jason-1-.cpp", "C++", 29, 0, 0, 0, 3, 10, 42
"d:\OI\Code\Comp\24-09-16 MX\T510091-MX-X4-T3-Jason-1-.cpp", "C++", 73, 0, 0, 0, 8, 18, 99
"d:\OI\Code\Comp\24-09-18 CF\A.cpp", "C++", 40, 0, 0, 0, 3, 11, 54
"d:\OI\Code\Comp\24-09-18 CF\B.cpp", "C++", 100, 0, 0, 0, 25, 23, 148
"d:\OI\Code\Comp\24-09-18 CF\F.cpp", "C++", 30, 0, 0, 0, 3, 13, 46
"d:\OI\Code\Comp\24-09-18 CF\K.cpp", "C++", 37, 0, 0, 0, 4, 14, 55
"d:\OI\Code\Comp\24-09-18 CF\M.cpp", "C++", 51, 0, 0, 0, 4, 17, 72
"d:\OI\Code\Comp\24-09-18 LCA\A.cpp", "C++", 133, 0, 0, 0, 16, 29, 178
"d:\OI\Code\Comp\24-09-18 MX\A.cpp", "C++", 34, 0, 0, 0, 3, 15, 52
"d:\OI\Code\Comp\24-09-18 MX\After\A.cpp", "C++", 48, 0, 0, 0, 4, 23, 75
"d:\OI\Code\Comp\24-09-18 MX\After\B-std.cpp", "C++", 76, 0, 0, 0, 2, 4, 82
"d:\OI\Code\Comp\24-09-18 MX\After\B.cpp", "C++", 109, 0, 0, 0, 6, 38, 153
"d:\OI\Code\Comp\24-09-18 MX\B.cpp", "C++", 101, 0, 0, 0, 3, 32, 136
"d:\OI\Code\Comp\24-09-21 CF974\2014B.cpp", "C++", 32, 0, 0, 0, 6, 13, 51
"d:\OI\Code\Comp\24-09-21 CF974\2014C.cpp", "C++", 55, 0, 0, 0, 4, 26, 85
"d:\OI\Code\Comp\24-09-21 CF974\2014D.cpp", "C++", 53, 0, 0, 0, 4, 19, 76
"d:\OI\Code\Comp\24-09-21 CF974\2014E.cpp", "C++", 91, 0, 0, 0, 4, 33, 128
"d:\OI\Code\Comp\24-09-21 CF974\2014F.cpp", "C++", 61, 0, 0, 0, 4, 27, 92
"d:\OI\Code\Comp\24-09-21 CF974\A.cpp", "C++", 37, 0, 0, 0, 4, 17, 58
"d:\OI\Code\Comp\24-09-22 MX\A.cpp", "C++", 47, 0, 0, 0, 4, 18, 69
"d:\OI\Code\Comp\24-09-22 MX\After\C.cpp", "C++", 117, 0, 0, 0, 12, 36, 165
"d:\OI\Code\Comp\24-09-22 MX\BCcode.cpp", "C++", 108, 0, 0, 0, 16, 34, 158
"d:\OI\Code\Comp\24-09-22 MX\B_gen.cpp", "C++", 71, 0, 0, 0, 18, 33, 122
"d:\OI\Code\Comp\24-09-22 MX\C.cpp", "C++", 0, 0, 0, 0, 0, 1, 1
"d:\OI\Code\Comp\24-09-22 MX\Cpalindrome.cpp", "C++", 59, 0, 0, 0, 4, 24, 87
"d:\OI\Code\Comp\24-09-25 MX\A.cpp", "C++", 99, 0, 0, 0, 4, 30, 133
"d:\OI\Code\Comp\24-09-25 MX\After\A.cpp", "C++", 60, 0, 0, 0, 4, 24, 88
"d:\OI\Code\Comp\24-09-25 MX\After\A1.cpp", "C++", 72, 0, 0, 0, 4, 29, 105
"d:\OI\Code\Comp\24-09-25 MX\After\B.cpp", "C++", 139, 0, 0, 0, 19, 50, 208
"d:\OI\Code\Comp\24-09-25 MX\B.cpp", "C++", 54, 0, 0, 0, 4, 16, 74
"d:\OI\Code\Comp\24-09-25 MX\luogu.cpp", "C++", 24, 0, 0, 0, 4, 13, 41
"d:\OI\Code\Comp\24-09-27 CF2019\20190.cpp", "C++", 43, 0, 0, 0, 4, 21, 68
"d:\OI\Code\Comp\24-09-27 CF2019\2019B.cpp", "C++", 50, 0, 0, 0, 4, 20, 74
"d:\OI\Code\Comp\24-09-27 CF2019\2019C.cpp", "C++", 43, 0, 0, 0, 4, 17, 64
"d:\OI\Code\Comp\24-09-29 CF\20200.cpp", "C++", 36, 0, 0, 0, 4, 15, 55
"d:\OI\Code\Comp\24-09-29 CF\2020B.cpp", "C++", 47, 0, 0, 0, 4, 16, 67
"d:\OI\Code\Comp\24-09-29 CF\2020D.cpp", "C++", 84, 0, 0, 0, 4, 30, 118
"d:\OI\Code\Comp\24-10-03 MX\A.cpp", "C++", 94, 0, 0, 0, 41, 40, 175
"d:\OI\Code\Comp\24-10-03 MX\A_gen.cpp", "C++", 34, 0, 0, 0, 9, 17, 60
"d:\OI\Code\Comp\24-10-03 MX\A_test.cpp", "C++", 30, 0, 0, 0, 4, 13, 47
"d:\OI\Code\Comp\24-10-03 MX\After\A.cpp", "C++", 66, 0, 0, 0, 4, 28, 98
"d:\OI\Code\Comp\24-10-03 MX\B.cpp", "C++", 53, 0, 0, 0, 4, 22, 79
"d:\OI\Code\Comp\24-10-03 MX\C.cpp", "C++", 109, 0, 0, 0, 4, 33, 146
"d:\OI\Code\Comp\24-10-06 CF\2021B.cpp", "C++", 44, 0, 0, 0, 4, 18, 66
"d:\OI\Code\Comp\24-10-06 CF\2021C1.cpp", "C++", 49, 0, 0, 0, 4, 19, 72
"d:\OI\Code\Comp\24-10-06 CF\2021C2.cpp", "C++", 86, 0, 0, 0, 5, 34, 125
"d:\OI\Code\Debug\gen.cpp", "C++", 23, 0, 0, 0, 0, 7, 30
"d:\OI\Code\Debug\me.cpp", "C++", 40, 0, 0, 0, 0, 15, 55
"d:\OI\Code\Debug\pai.cpp", "C++", 32, 0, 0, 0, 0, 11, 43
"d:\OI\Code\Debug\std.cpp", "C++", 56, 0, 0, 0, 3, 4, 63
"d:\OI\Code\Debug\sum.cpp", "C++", 1, 0, 0, 0, 0, 0, 1
"d:\OI\Code\HDU\4003.cpp", "C++", 73, 0, 0, 0, 2, 21, 96
"d:\OI\Code\LibreOJ\111.cpp", "C++", 50, 0, 0, 0, 0, 18, 68
"d:\OI\Code\LibreOJ\537.cpp", "C++", 32, 0, 0, 0, 0, 11, 43
"d:\OI\Code\LibreOJ\6029.cpp", "C++", 121, 0, 0, 0, 3, 41, 165
"d:\OI\Code\LibreOJ\6278.cpp", "C++", 88, 0, 0, 0, 2, 29, 119
"d:\OI\Code\Luogu\1073E.cpp", "C++", 65, 0, 0, 0, 3, 28, 96
"d:\OI\Code\Luogu\AT_abc138_f.cpp", "C++", 51, 0, 0, 0, 5, 23, 79
"d:\OI\Code\Luogu\AT_abc219_f.cpp", "C++", 69, 0, 0, 0, 3, 22, 94
"d:\OI\Code\Luogu\AT_abc270_g.cpp", "C++", 79, 0, 0, 0, 2, 24, 105
"d:\OI\Code\Luogu\AT_abc308_g.cpp", "C++", 110, 0, 0, 0, 2, 32, 144
"d:\OI\Code\Luogu\AT_abc327_f.cpp", "C++", 87, 0, 0, 0, 4, 28, 119
"d:\OI\Code\Luogu\AT_abc365_f.cpp", "C++", 93, 0, 0, 0, 1, 28, 122
"d:\OI\Code\Luogu\AT_agc001_c.cpp", "C++", 79, 0, 0, 0, 1, 24, 104
"d:\OI\Code\Luogu\AT_agc012_d.cpp", "C++", 79, 0, 0, 0, 4, 30, 113
"d:\OI\Code\Luogu\AT_agc013_e.cpp", "C++", 74, 0, 0, 0, 4, 25, 103
"d:\OI\Code\Luogu\AT_agc059_a.cpp", "C++", 36, 0, 0, 0, 0, 15, 51
"d:\OI\Code\Luogu\AT_arc071_d.cpp", "C++", 38, 0, 0, 0, 3, 14, 55
"d:\OI\Code\Luogu\AT_arc084_b.cpp", "C++", 72, 0, 0, 0, 0, 25, 97
"d:\OI\Code\Luogu\AT_arc092_d.cpp", "C++", 81, 0, 0, 0, 1, 28, 110
"d:\OI\Code\Luogu\AT_arc100_c.cpp", "C++", 53, 0, 0, 0, 0, 15, 68
"d:\OI\Code\Luogu\AT_arc105_c.cpp", "C++", 62, 0, 0, 0, 6, 23, 91
"d:\OI\Code\Luogu\AT_dp_a.cpp", "C++", 31, 0, 0, 0, 0, 12, 43
"d:\OI\Code\Luogu\AT_dp_b.cpp", "C++", 32, 0, 0, 0, 0, 13, 45
"d:\OI\Code\Luogu\AT_dp_c.cpp", "C++", 34, 0, 0, 0, 0, 13, 47
"d:\OI\Code\Luogu\AT_dp_d.cpp", "C++", 32, 0, 0, 0, 0, 12, 44
"d:\OI\Code\Luogu\AT_dp_e.cpp", "C++", 36, 0, 0, 0, 0, 13, 49
"d:\OI\Code\Luogu\AT_dp_f.cpp", "C++", 47, 0, 0, 0, 0, 16, 63
"d:\OI\Code\Luogu\AT_dp_z.cpp", "C++", 72, 0, 0, 0, 0, 26, 98
"d:\OI\Code\Luogu\AT_dwacon6th_prelims_c.cpp", "C++", 93, 0, 0, 0, 3, 22, 118
"d:\OI\Code\Luogu\AT_joisc2019_h.cpp", "C++", 51, 0, 0, 0, 0, 15, 66
"d:\OI\Code\Luogu\B3606.cpp", "C++", 100, 0, 0, 0, 0, 23, 123
"d:\OI\Code\Luogu\B3607.cpp", "C++", 100, 0, 0, 0, 0, 23, 123
"d:\OI\Code\Luogu\B3611.cpp", "C++", 41, 0, 0, 0, 0, 10, 51
"d:\OI\Code\Luogu\B3647.cpp", "C++", 55, 0, 0, 0, 0, 14, 69
"d:\OI\Code\Luogu\CF1033C.cpp", "C++", 66, 0, 0, 0, 0, 16, 82
"d:\OI\Code\Luogu\CF1039D.cpp", "C++", 80, 0, 0, 0, 3, 31, 114
"d:\OI\Code\Luogu\CF10D.cpp", "C++", 49, 0, 0, 0, 1, 21, 71
"d:\OI\Code\Luogu\CF1109B.cpp", "C++", 35, 0, 0, 0, 0, 11, 46
"d:\OI\Code\Luogu\CF111D.cpp", "C++", 73, 0, 0, 0, 19, 26, 118
"d:\OI\Code\Luogu\CF1178E.cpp", "C++", 42, 0, 0, 0, 0, 12, 54
"d:\OI\Code\Luogu\CF1178F1.cpp", "C++", 54, 0, 0, 0, 0, 18, 72
"d:\OI\Code\Luogu\CF117C.cpp", "C++", 45, 0, 0, 0, 0, 14, 59
"d:\OI\Code\Luogu\CF1198D.cpp", "C++", 56, 0, 0, 0, 0, 14, 70
"d:\OI\Code\Luogu\CF1209E1.cpp", "C++", 71, 0, 0, 0, 0, 23, 94
"d:\OI\Code\Luogu\CF1209E2.cpp", "C++", 71, 0, 0, 0, 0, 23, 94
"d:\OI\Code\Luogu\CF1221F.cpp", "C++", 95, 0, 0, 0, 0, 36, 131
"d:\OI\Code\Luogu\CF1238E.cpp", "C++", 52, 0, 0, 0, 0, 16, 68
"d:\OI\Code\Luogu\CF1245F.cpp", "C++", 50, 0, 0, 0, 4, 23, 77
"d:\OI\Code\Luogu\CF1264E_SimulateAnneal.cpp", "C++", 115, 0, 0, 0, 0, 29, 144
"d:\OI\Code\Luogu\CF1307D.cpp", "C++", 62, 0, 0, 0, 3, 25, 90
"d:\OI\Code\Luogu\CF1352B.cpp", "C++", 42, 0, 0, 0, 0, 13, 55
"d:\OI\Code\Luogu\CF1353A.cpp", "C++", 28, 0, 0, 0, 0, 11, 39
"d:\OI\Code\Luogu\CF1364D.cpp", "C++", 116, 0, 0, 0, 0, 29, 145
"d:\OI\Code\Luogu\CF1389A.cpp", "C++", 30, 0, 0, 0, 0, 8, 38
"d:\OI\Code\Luogu\CF1406E.cpp", "C++", 103, 0, 0, 0, 4, 31, 138
"d:\OI\Code\Luogu\CF1420E.cpp", "C++", 67, 0, 0, 0, 1, 21, 89
"d:\OI\Code\Luogu\CF1553H.cpp", "C++", 59, 0, 0, 0, 1, 22, 82
"d:\OI\Code\Luogu\CF1556E.cpp", "C++", 67, 0, 0, 0, 0, 21, 88
"d:\OI\Code\Luogu\CF1583F.cpp", "C++", 41, 0, 0, 0, 0, 14, 55
"d:\OI\Code\Luogu\CF1637D.cpp", "C++", 51, 0, 0, 0, 3, 21, 75
"d:\OI\Code\Luogu\CF1646E.cpp", "C++", 47, 0, 0, 0, 0, 17, 64
"d:\OI\Code\Luogu\CF165E.cpp", "C++", 38, 0, 0, 0, 0, 16, 54
"d:\OI\Code\Luogu\CF1675G.cpp", "C++", 47, 0, 0, 0, 3, 17, 67
"d:\OI\Code\Luogu\CF1725L.cpp", "C++", 70, 0, 0, 0, 1, 26, 97
"d:\OI\Code\Luogu\CF1762D.cpp", "C++", 46, 0, 0, 0, 6, 19, 71
"d:\OI\Code\Luogu\CF1806E.cpp", "C++", 53, 0, 0, 0, 0, 14, 67
"d:\OI\Code\Luogu\CF1864F.cpp", "C++", 105, 0, 0, 0, 0, 39, 144
"d:\OI\Code\Luogu\CF1916E.cpp", "C++", 151, 0, 0, 0, 1, 51, 203
"d:\OI\Code\Luogu\CF1998B.cpp", "C++", 35, 0, 0, 0, 0, 14, 49
"d:\OI\Code\Luogu\CF2014H.cpp", "C++", 51, 0, 0, 0, 4, 20, 75
"d:\OI\Code\Luogu\CF2018B.cpp", "C++", 50, 0, 0, 0, 4, 19, 73
"d:\OI\Code\Luogu\CF2018C.cpp", "C++", 72, 0, 0, 0, 5, 26, 103
"d:\OI\Code\Luogu\CF235B.cpp", "C++", 32, 0, 0, 0, 0, 12, 44
"d:\OI\Code\Luogu\CF280C.cpp", "C++", 51, 0, 0, 0, 0, 15, 66
"d:\OI\Code\Luogu\CF282E.cpp", "C++", 69, 0, 0, 0, 0, 25, 94
"d:\OI\Code\Luogu\CF288D.cpp", "C++", 65, 0, 0, 0, 1, 25, 91
"d:\OI\Code\Luogu\CF294B.cpp", "C++", 45, 0, 0, 0, 4, 18, 67
"d:\OI\Code\Luogu\CF367D.cpp", "C++", 65, 0, 0, 0, 0, 23, 88
"d:\OI\Code\Luogu\CF379D.cpp", "C++", 76, 0, 0, 0, 7, 30, 113
"d:\OI\Code\Luogu\CF383C.cpp", "C++", 84, 0, 0, 0, 1, 24, 109
"d:\OI\Code\Luogu\CF383E.cpp", "C++", 49, 0, 0, 0, 0, 16, 65
"d:\OI\Code\Luogu\CF420D.cpp", "C++", 110, 0, 0, 0, 9, 36, 155
"d:\OI\Code\Luogu\CF438D.cpp", "C++", 88, 0, 0, 0, 0, 31, 119
"d:\OI\Code\Luogu\CF444C.cpp", "C++", 102, 0, 0, 0, 3, 28, 133
"d:\OI\Code\Luogu\CF446C.cpp", "C++", 129, 0, 0, 0, 15, 48, 192
"d:\OI\Code\Luogu\CF448E.cpp", "C++", 41, 0, 0, 0, 2, 16, 59
"d:\OI\Code\Luogu\CF452F.cpp", "C++", 70, 0, 0, 0, 0, 28, 98
"d:\OI\Code\Luogu\CF496C.cpp", "C++", 46, 0, 0, 0, 2, 18, 66
"d:\OI\Code\Luogu\CF508D.cpp", "C++", 70, 0, 0, 0, 1, 27, 98
"d:\OI\Code\Luogu\CF542F.cpp", "C++", 44, 0, 0, 0, 0, 18, 62
"d:\OI\Code\Luogu\CF547C.cpp", "C++", 73, 0, 0, 0, 4, 27, 104
"d:\OI\Code\Luogu\CF547D.cpp", "C++", 52, 0, 0, 0, 0, 15, 67
"d:\OI\Code\Luogu\CF55D.cpp", "C++", 65, 0, 0, 0, 4, 26, 95
"d:\OI\Code\Luogu\CF570D.cpp", "C++", 110, 0, 0, 0, 0, 39, 149
"d:\OI\Code\Luogu\CF600E.cpp", "C++", 82, 0, 0, 0, 0, 28, 110
"d:\OI\Code\Luogu\CF607B.cpp", "C++", 41, 0, 0, 0, 0, 16, 57
"d:\OI\Code\Luogu\CF628D.cpp", "C++", 73, 0, 0, 0, 9, 28, 110
"d:\OI\Code\Luogu\CF628D_1.cpp", "C++", 82, 0, 0, 0, 0, 30, 112
"d:\OI\Code\Luogu\CF702F.cpp", "C++", 115, 0, 0, 0, 2, 35, 152
"d:\OI\Code\Luogu\CF717F.cpp", "C++", 128, 0, 0, 0, 11, 34, 173
"d:\OI\Code\Luogu\CF748C.cpp", "C++", 44, 0, 0, 0, 0, 14, 58
"d:\OI\Code\Luogu\CF778C.cpp", "C++", 61, 0, 0, 0, 0, 23, 84
"d:\OI\Code\Luogu\CF797E.cpp", "C++", 52, 0, 0, 0, 3, 17, 72
"d:\OI\Code\Luogu\CF797F.cpp", "C++", 53, 0, 0, 0, 0, 20, 73
"d:\OI\Code\Luogu\CF79D.cpp", "C++", 84, 0, 0, 0, 4, 31, 119
"d:\OI\Code\Luogu\CF833B.cpp", "C++", 70, 0, 0, 0, 1, 28, 99
"d:\OI\Code\Luogu\CF888E.cpp", "C++", 50, 0, 0, 0, 0, 17, 67
"d:\OI\Code\Luogu\CF891C.cpp", "C++", 115, 0, 0, 0, 1, 36, 152
"d:\OI\Code\Luogu\CF896C.cpp", "C++", 114, 0, 0, 0, 0, 33, 147
"d:\OI\Code\Luogu\CF898C.cpp", "C++", 79, 0, 0, 0, 0, 24, 103
"d:\OI\Code\Luogu\CF906C.cpp", "C++", 63, 0, 0, 0, 0, 23, 86
"d:\OI\Code\Luogu\CF915E.cpp", "C++", 58, 0, 0, 0, 0, 22, 80
"d:\OI\Code\Luogu\CF93E.cpp", "C++", 25, 0, 0, 0, 0, 14, 39
"d:\OI\Code\Luogu\CF988D.cpp", "C++", 51, 0, 0, 0, 2, 12, 65
"d:\OI\Code\Luogu\CF997B.cpp", "C++", 48, 0, 0, 0, 1, 17, 66
"d:\OI\Code\Luogu\P10200.cpp", "C++", 104, 0, 0, 0, 3, 31, 138
"d:\OI\Code\Luogu\P10446.cpp", "C++", 33, 0, 0, 0, 2, 12, 47
"d:\OI\Code\Luogu\P10447.cpp", "C++", 50, 0, 0, 0, 2, 17, 69
"d:\OI\Code\Luogu\P10596.cpp", "C++", 54, 0, 0, 0, 1, 19, 74
"d:\OI\Code\Luogu\P10692.cpp", "C++", 93, 0, 0, 0, 3, 28, 124
"d:\OI\Code\Luogu\P1070.cpp", "C++", 55, 0, 0, 0, 0, 13, 68
"d:\OI\Code\Luogu\P10766.cpp", "C++", 54, 0, 0, 0, 0, 17, 71
"d:\OI\Code\Luogu\P1084.cpp", "C++", 159, 0, 0, 0, 1, 42, 202
"d:\OI\Code\Luogu\P1087.cpp", "C++", 74, 0, 0, 0, 0, 15, 89
"d:\OI\Code\Luogu\P10885.cpp", "C++", 82, 0, 0, 0, 2, 25, 109
"d:\OI\Code\Luogu\P10886.cpp", "C++", 80, 0, 0, 0, 1, 24, 105
"d:\OI\Code\Luogu\P11063.cpp", "C++", 70, 0, 0, 0, 5, 17, 92
"d:\OI\Code\Luogu\P1110.cpp", "C++", 118, 0, 0, 0, 0, 31, 149
"d:\OI\Code\Luogu\P1111.cpp", "C++", 67, 0, 0, 0, 0, 10, 77
"d:\OI\Code\Luogu\P1122.cpp", "C++", 63, 0, 0, 0, 0, 16, 79
"d:\OI\Code\Luogu\P1129.cpp", "C++", 109, 0, 0, 0, 0, 35, 144
"d:\OI\Code\Luogu\P1133.cpp", "C++", 53, 0, 0, 0, 0, 9, 62
"d:\OI\Code\Luogu\P1168.cpp", "C++", 57, 0, 0, 0, 3, 22, 82
"d:\OI\Code\Luogu\P1198.cpp", "C++", 75, 0, 0, 0, 1, 24, 100
"d:\OI\Code\Luogu\P1220.cpp", "C++", 51, 0, 0, 0, 0, 15, 66
"d:\OI\Code\Luogu\P1226.cpp", "C++", 28, 0, 0, 0, 0, 4, 32
"d:\OI\Code\Luogu\P1255.cpp", "C++", 60, 0, 0, 0, 0, 23, 83
"d:\OI\Code\Luogu\P1311.cpp", "C++", 48, 0, 0, 0, 0, 17, 65
"d:\OI\Code\Luogu\P1314.cpp", "C++", 57, 0, 0, 0, 0, 22, 79
"d:\OI\Code\Luogu\P1331.cpp", "C++", 99, 0, 0, 0, 5, 14, 118
"d:\OI\Code\Luogu\P1350.cpp", "C++", 63, 0, 0, 0, 3, 21, 87
"d:\OI\Code\Luogu\P1362.cpp", "C++", 47, 0, 0, 0, 0, 13, 60
"d:\OI\Code\Luogu\P1365.cpp", "C++", 36, 0, 0, 0, 3, 13, 52
"d:\OI\Code\Luogu\P1377.cpp", "C++", 57, 0, 0, 0, 3, 18, 78
"d:\OI\Code\Luogu\P1390.cpp", "C++", 18, 0, 0, 0, 0, 11, 29
"d:\OI\Code\Luogu\P1403.cpp", "C++", 27, 0, 0, 0, 0, 11, 38
"d:\OI\Code\Luogu\P1434.cpp", "C++", 48, 0, 0, 0, 0, 10, 58
"d:\OI\Code\Luogu\P1450.cpp", "C++", 67, 0, 0, 0, 2, 21, 90
"d:\OI\Code\Luogu\P1451.cpp", "C++", 48, 0, 0, 0, 0, 16, 64
"d:\OI\Code\Luogu\P1486.cpp", "C++", 83, 0, 0, 0, 0, 23, 106
"d:\OI\Code\Luogu\P1495.cpp", "C++", 45, 0, 0, 0, 0, 13, 58
"d:\OI\Code\Luogu\P1501.cpp", "C++", 114, 0, 0, 0, 0, 31, 145
"d:\OI\Code\Luogu\P1502.cpp", "C++", 121, 0, 0, 0, 19, 44, 184
"d:\OI\Code\Luogu\P1503.cpp", "C++", 105, 0, 0, 0, 0, 28, 133
"d:\OI\Code\Luogu\P1525.cpp", "C++", 79, 0, 0, 0, 0, 26, 105
"d:\OI\Code\Luogu\P1588.cpp", "C++", 43, 0, 0, 0, 0, 15, 58
"d:\OI\Code\Luogu\P1593.cpp", "C++", 55, 0, 0, 0, 3, 19, 77
"d:\OI\Code\Luogu\P1596.cpp", "C++", 49, 0, 0, 0, 0, 18, 67
"d:\OI\Code\Luogu\P1601.cpp", "C++", 42, 0, 0, 0, 1, 10, 53
"d:\OI\Code\Luogu\P1637.cpp", "C++", 46, 0, 0, 0, 0, 18, 64
"d:\OI\Code\Luogu\P1638.cpp", "C++", 51, 0, 0, 0, 0, 21, 72
"d:\OI\Code\Luogu\P1654.cpp", "C++", 35, 0, 0, 0, 7, 13, 55
"d:\OI\Code\Luogu\P1712.cpp", "C++", 84, 0, 0, 0, 1, 30, 115
"d:\OI\Code\Luogu\P1725.cpp", "C++", 39, 0, 0, 0, 4, 16, 59
"d:\OI\Code\Luogu\P1799.cpp", "C++", 21, 0, 0, 0, 0, 11, 32
"d:\OI\Code\Luogu\P1807.cpp", "C++", 67, 0, 0, 0, 0, 22, 89
"d:\OI\Code\Luogu\P1874.cpp", "C++", 66, 0, 0, 0, 0, 17, 83
"d:\OI\Code\Luogu\P1880.cpp", "C++", 52, 0, 0, 0, 0, 16, 68
"d:\OI\Code\Luogu\P1896.cpp", "C++", 63, 0, 0, 0, 0, 19, 82
"d:\OI\Code\Luogu\P1955.cpp", "C++", 81, 0, 0, 0, 0, 25, 106
"d:\OI\Code\Luogu\P1962.cpp", "C++", 86, 0, 0, 0, 0, 20, 106
"d:\OI\Code\Luogu\P1966.cpp", "C++", 51, 0, 0, 0, 3, 22, 76
"d:\OI\Code\Luogu\P1967.cpp", "C++", 118, 0, 0, 0, 0, 46, 164
"d:\OI\Code\Luogu\P1969.cpp", "C++", 28, 0, 0, 0, 0, 12, 40
"d:\OI\Code\Luogu\P1972.cpp", "C++", 61, 0, 0, 0, 0, 26, 87
"d:\OI\Code\Luogu\P2042.cpp", "C++", 197, 0, 0, 0, 3, 45, 245
"d:\OI\Code\Luogu\P2048.cpp", "C++", 19, 0, 0, 0, 0, 6, 25
"d:\OI\Code\Luogu\P2114.cpp", "C++", 70, 0, 0, 0, 3, 22, 95
"d:\OI\Code\Luogu\P2147.cpp", "C++", 77, 0, 0, 0, 0, 22, 99
"d:\OI\Code\Luogu\P2173.cpp", "C++", 144, 0, 0, 0, 0, 38, 182
"d:\OI\Code\Luogu\P2184.cpp", "C++", 56, 0, 0, 0, 0, 17, 73
"d:\OI\Code\Luogu\P2196.cpp", "C++", 88, 0, 0, 0, 0, 22, 110
"d:\OI\Code\Luogu\P2197.cpp", "C++", 37, 0, 0, 0, 0, 11, 48
"d:\OI\Code\Luogu\P2233.cpp", "C++", 88, 0, 0, 0, 1, 21, 110
"d:\OI\Code\Luogu\P2261.cpp", "C++", 33, 0, 0, 0, 0, 12, 45
"d:\OI\Code\Luogu\P2285.cpp", "C++", 53, 0, 0, 0, 0, 15, 68
"d:\OI\Code\Luogu\P2286.cpp", "C++", 110, 0, 0, 0, 0, 32, 142
"d:\OI\Code\Luogu\P2371.cpp", "C++", 90, 0, 0, 0, 2, 27, 119
"d:\OI\Code\Luogu\P2387.cpp", "C++", 114, 0, 0, 0, 0, 31, 145
"d:\OI\Code\Luogu\P2391.cpp", "C++", 44, 0, 0, 0, 0, 15, 59
"d:\OI\Code\Luogu\P2398.cpp", "C++", 16, 0, 0, 0, 0, 10, 26
"d:\OI\Code\Luogu\P2422.cpp", "C++", 49, 0, 0, 0, 3, 19, 71
"d:\OI\Code\Luogu\P2480.cpp", "C++", 73, 0, 0, 0, 2, 26, 101
"d:\OI\Code\Luogu\P2485.cpp", "C++", 111, 0, 0, 0, 4, 20, 135
"d:\OI\Code\Luogu\P2522.cpp", "C++", 60, 0, 0, 0, 0, 21, 81
"d:\OI\Code\Luogu\P2568.cpp", "C++", 41, 0, 0, 0, 0, 16, 57
"d:\OI\Code\Luogu\P2574.cpp", "C++", 54, 0, 0, 0, 0, 21, 75
"d:\OI\Code\Luogu\P2585.cpp", "C++", 71, 0, 0, 0, 0, 19, 90
"d:\OI\Code\Luogu\P2617.cpp", "C++", 77, 0, 0, 0, 0, 32, 109
"d:\OI\Code\Luogu\P2619.cpp", "C++", 80, 0, 0, 0, 17, 28, 125
"d:\OI\Code\Luogu\P2656.cpp", "C++", 144, 0, 0, 0, 0, 31, 175
"d:\OI\Code\Luogu\P2657.cpp", "C++", 52, 0, 0, 0, 0, 18, 70
"d:\OI\Code\Luogu\P2671.cpp", "C++", 45, 0, 0, 0, 2, 17, 64
"d:\OI\Code\Luogu\P2679.cpp", "C++", 49, 0, 0, 0, 0, 11, 60
"d:\OI\Code\Luogu\P2680.cpp", "C++", 192, 0, 0, 0, 13, 36, 241
"d:\OI\Code\Luogu\P2704.cpp", "C++", 76, 0, 0, 0, 1, 21, 98
"d:\OI\Code\Luogu\P2734.cpp", "C++", 44, 0, 0, 0, 0, 11, 55
"d:\OI\Code\Luogu\P2756.cpp", "C++", 112, 0, 0, 0, 0, 32, 144
"d:\OI\Code\Luogu\P2757.cpp", "C++", 74, 0, 0, 0, 0, 32, 106
"d:\OI\Code\Luogu\P2762.cpp", "C++", 124, 0, 0, 0, 1, 29, 154
"d:\OI\Code\Luogu\P2763.cpp", "C++", 134, 0, 0, 0, 0, 39, 173
"d:\OI\Code\Luogu\P2766.cpp", "C++", 137, 0, 0, 0, 0, 35, 172
"d:\OI\Code\Luogu\P2822.cpp", "C++", 47, 0, 0, 0, 3, 18, 68
"d:\OI\Code\Luogu\P2846.cpp", "C++", 50, 0, 0, 0, 0, 21, 71
"d:\OI\Code\Luogu\P2862.cpp", "C++", 99, 0, 0, 0, 4, 31, 134
"d:\OI\Code\Luogu\P2865.cpp", "C++", 19, 0, 0, 0, 0, 6, 25
"d:\OI\Code\Luogu\P2885.cpp", "C++", 52, 0, 0, 0, 0, 13, 65
"d:\OI\Code\Luogu\P2886.cpp", "C++", 71, 0, 0, 0, 0, 15, 86
"d:\OI\Code\Luogu\P2891.cpp", "C++", 20, 0, 0, 0, 0, 4, 24
"d:\OI\Code\Luogu\P3034.cpp", "C++", 41, 0, 0, 0, 0, 14, 55
"d:\OI\Code\Luogu\P3043.cpp", "C++", 47, 0, 0, 0, 0, 17, 64
"d:\OI\Code\Luogu\P3078.cpp", "C++", 28, 0, 0, 0, 0, 12, 40
"d:\OI\Code\Luogu\P3129.cpp", "C++", 51, 0, 0, 0, 2, 18, 71
"d:\OI\Code\Luogu\P3146.cpp", "C++", 42, 0, 0, 0, 0, 15, 57
"d:\OI\Code\Luogu\P3157.cpp", "C++", 74, 0, 0, 0, 1, 29, 104
"d:\OI\Code\Luogu\P3165.cpp", "C++", 111, 0, 0, 0, 0, 32, 143
"d:\OI\Code\Luogu\P3178.cpp", "C++", 155, 0, 0, 0, 2, 51, 208
"d:\OI\Code\Luogu\P3186.cpp", "C++", 73, 0, 0, 0, 3, 23, 99
"d:\OI\Code\Luogu\P3195.cpp", "C++", 42, 0, 0, 0, 1, 17, 60
"d:\OI\Code\Luogu\P3203.cpp", "C++", 74, 0, 0, 0, 3, 22, 99
"d:\OI\Code\Luogu\P3205.cpp", "C++", 28, 0, 0, 0, 0, 6, 34
"d:\OI\Code\Luogu\P3224.cpp", "C++", 104, 0, 0, 0, 0, 30, 134
"d:\OI\Code\Luogu\P3246.cpp", "C++", 79, 0, 0, 0, 3, 24, 106
"d:\OI\Code\Luogu\P3247.cpp", "C++", 148, 0, 0, 0, 11, 54, 213
"d:\OI\Code\Luogu\P3254.cpp", "C++", 120, 0, 0, 0, 4, 32, 156
"d:\OI\Code\Luogu\P3285.cpp", "C++", 89, 0, 0, 0, 23, 32, 144
"d:\OI\Code\Luogu\P3293.cpp", "C++", 72, 0, 0, 0, 0, 31, 103
"d:\OI\Code\Luogu\P3295.cpp", "C++", 72, 0, 0, 0, 2, 23, 97
"d:\OI\Code\Luogu\P3306.cpp", "C++", 87, 0, 0, 0, 4, 25, 116
"d:\OI\Code\Luogu\P3308.cpp", "C++", 170, 0, 0, 0, 4, 50, 224
"d:\OI\Code\Luogu\P3357.cpp", "C++", 134, 0, 0, 0, 1, 42, 177
"d:\OI\Code\Luogu\P3358.cpp", "C++", 128, 0, 0, 0, 40, 43, 211
"d:\OI\Code\Luogu\P3369.cpp", "C++", 122, 0, 0, 0, 0, 30, 152
"d:\OI\Code\Luogu\P3369_a.cpp", "C++", 116, 0, 0, 0, 0, 31, 147
"d:\OI\Code\Luogu\P3369_fhq.cpp", "C++", 117, 0, 0, 0, 0, 34, 151
"d:\OI\Code\Luogu\P3372.cpp", "C++", 82, 0, 0, 0, 1, 31, 114
"d:\OI\Code\Luogu\P3379.cpp", "C++", 78, 0, 0, 0, 0, 19, 97
"d:\OI\Code\Luogu\P3381.cpp", "C++", 103, 0, 0, 0, 0, 29, 132
"d:\OI\Code\Luogu\P3381_simplex.cpp", "C++", 146, 0, 0, 0, 22, 48, 216
"d:\OI\Code\Luogu\P3388.cpp", "C++", 67, 0, 0, 0, 0, 23, 90
"d:\OI\Code\Luogu\P3391.cpp", "C++", 92, 0, 0, 0, 0, 27, 119
"d:\OI\Code\Luogu\P3391_fhq.cpp", "C++", 91, 0, 0, 0, 0, 27, 118
"d:\OI\Code\Luogu\P3403.cpp", "C++", 82, 0, 0, 0, 1, 23, 106
"d:\OI\Code\Luogu\P3455.cpp", "C++", 61, 0, 0, 0, 0, 21, 82
"d:\OI\Code\Luogu\P3469.cpp", "C++", 78, 0, 0, 0, 0, 30, 108
"d:\OI\Code\Luogu\P3586.cpp", "C++", 82, 0, 0, 0, 0, 28, 110
"d:\OI\Code\Luogu\P3649.cpp", "C++", 63, 0, 0, 0, 0, 18, 81
"d:\OI\Code\Luogu\P3690.cpp", "C++", 90, 0, 0, 0, 0, 22, 112
"d:\OI\Code\Luogu\P3690_1.cpp", "C++", 91, 0, 0, 0, 0, 23, 114
"d:\OI\Code\Luogu\P3746.cpp", "C++", 58, 0, 0, 0, 3, 19, 80
"d:\OI\Code\Luogu\P3792.cpp", "C++", 97, 0, 0, 0, 3, 25, 125
"d:\OI\Code\Luogu\P3793.cpp", "C++", 76, 0, 0, 0, 0, 19, 95
"d:\OI\Code\Luogu\P3804.cpp", "C++", 84, 0, 0, 0, 0, 28, 112
"d:\OI\Code\Luogu\P3804_a.cpp", "C++", 79, 0, 0, 0, 1, 28, 108
"d:\OI\Code\Luogu\P3805.cpp", "C++", 76, 0, 0, 0, 0, 26, 102
"d:\OI\Code\Luogu\P3806.cpp", "C++", 124, 0, 0, 0, 1, 39, 164
"d:\OI\Code\Luogu\P3806_a.cpp", "C++", 121, 0, 0, 0, 0, 38, 159
"d:\OI\Code\Luogu\P3809.cpp", "C++", 50, 0, 0, 0, 2, 18, 70
"d:\OI\Code\Luogu\P3809_a.cpp", "C++", 50, 0, 0, 0, 0, 17, 67
"d:\OI\Code\Luogu\P3810.cpp", "C++", 83, 0, 0, 0, 3, 29, 115
"d:\OI\Code\Luogu\P3812.cpp", "C++", 42, 0, 0, 0, 0, 10, 52
"d:\OI\Code\Luogu\P3831.cpp", "C++", 94, 0, 0, 0, 3, 29, 126
"d:\OI\Code\Luogu\P3833.cpp", "C++", 135, 0, 0, 0, 0, 29, 164
"d:\OI\Code\Luogu\P3835.cpp", "C++", 114, 0, 0, 0, 0, 29, 143
"d:\OI\Code\Luogu\P3846.cpp", "C++", 52, 0, 0, 0, 3, 13, 68
"d:\OI\Code\Luogu\P3865.cpp", "C++", 50, 0, 0, 0, 0, 16, 66
"d:\OI\Code\Luogu\P3868.cpp", "C++", 69, 0, 0, 0, 2, 18, 89
"d:\OI\Code\Luogu\P3870.cpp", "C++", 50, 0, 0, 0, 0, 20, 70
"d:\OI\Code\Luogu\P3911.cpp", "C++", 66, 0, 0, 0, 0, 22, 88
"d:\OI\Code\Luogu\P3917.cpp", "C++", 48, 0, 0, 0, 0, 17, 65
"d:\OI\Code\Luogu\P3919.cpp", "C++", 67, 0, 0, 0, 0, 23, 90
"d:\OI\Code\Luogu\P3953.cpp", "C++", 138, 0, 0, 0, 1, 29, 168
"d:\OI\Code\Luogu\P3975.cpp", "C++", 108, 0, 0, 0, 0, 32, 140
"d:\OI\Code\Luogu\P4008.cpp", "C++", 98, 0, 0, 0, 1, 26, 125
"d:\OI\Code\Luogu\P4014.cpp", "C++", 128, 0, 0, 0, 0, 38, 166
"d:\OI\Code\Luogu\P4015.cpp", "C++", 130, 0, 0, 0, 1, 42, 173
"d:\OI\Code\Luogu\P4051.cpp", "C++", 53, 0, 0, 0, 1, 18, 72
"d:\OI\Code\Luogu\P4121.cpp", "C++", 109, 0, 0, 0, 2, 43, 154
"d:\OI\Code\Luogu\P4136.cpp", "C++", 24, 0, 0, 0, 0, 7, 31
"d:\OI\Code\Luogu\P4145.cpp", "C++", 74, 0, 0, 0, 0, 26, 100
"d:\OI\Code\Luogu\P4151.cpp", "C++", 66, 0, 0, 0, 0, 16, 82
"d:\OI\Code\Luogu\P4159.cpp", "C++", 115, 0, 0, 0, 0, 27, 142
"d:\OI\Code\Luogu\P4168.cpp", "C++", 131, 0, 0, 0, 14, 39, 184
"d:\OI\Code\Luogu\P4171.cpp", "C++", 101, 0, 0, 0, 3, 31, 135
"d:\OI\Code\Luogu\P4172.cpp", "C++", 134, 0, 0, 0, 0, 35, 169
"d:\OI\Code\Luogu\P4194.cpp", "C++", 147, 0, 0, 0, 0, 38, 185
"d:\OI\Code\Luogu\P4249.cpp", "C++", 108, 0, 0, 0, 0, 27, 135
"d:\OI\Code\Luogu\P4251.cpp", "C++", 80, 0, 0, 0, 0, 24, 104
"d:\OI\Code\Luogu\P4281.cpp", "C++", 102, 0, 0, 0, 1, 28, 131
"d:\OI\Code\Luogu\P4290.cpp", "C++", 93, 0, 0, 0, 0, 12, 105
"d:\OI\Code\Luogu\P4312.cpp", "C++", 86, 0, 0, 0, 0, 24, 110
"d:\OI\Code\Luogu\P4316.cpp", "C++", 53, 0, 0, 0, 0, 18, 71
"d:\OI\Code\Luogu\P4322.cpp", "C++", 90, 0, 0, 0, 1, 27, 118
"d:\OI\Code\Luogu\P4342.cpp", "C++", 78, 0, 0, 0, 1, 15, 94
"d:\OI\Code\Luogu\P4396.cpp", "C++", 144, 0, 0, 0, 5, 44, 193
"d:\OI\Code\Luogu\P4513.cpp", "C++", 76, 0, 0, 0, 1, 32, 109
"d:\OI\Code\Luogu\P4516.cpp", "C++", 90, 0, 0, 0, 1, 27, 118
"d:\OI\Code\Luogu\P4556.cpp", "C++", 156, 0, 0, 0, 1, 45, 202
"d:\OI\Code\Luogu\P4567.cpp", "C++", 109, 0, 0, 0, 2, 29, 140
"d:\OI\Code\Luogu\P4568.cpp", "C++", 87, 0, 0, 0, 0, 22, 109
"d:\OI\Code\Luogu\P4570.cpp", "C++", 49, 0, 0, 0, 0, 14, 63
"d:\OI\Code\Luogu\P4592.cpp", "C++", 136, 0, 0, 0, 0, 41, 177
"d:\OI\Code\Luogu\P4735.cpp", "C++", 85, 0, 0, 0, 0, 26, 111
"d:\OI\Code\Luogu\P4755.cpp", "C++", 110, 0, 0, 0, 3, 32, 145
"d:\OI\Code\Luogu\P4774.cpp", "C++", 119, 0, 0, 0, 2, 32, 153
"d:\OI\Code\Luogu\P4777.cpp", "C++", 93, 0, 0, 0, 0, 19, 112
"d:\OI\Code\Luogu\P4777_a.cpp", "C++", 99, 0, 0, 0, 0, 17, 116
"d:\OI\Code\Luogu\P4779.cpp", "C++", 79, 0, 0, 0, 0, 19, 98
"d:\OI\Code\Luogu\P4782.cpp", "C++", 106, 0, 0, 0, 0, 21, 127
"d:\OI\Code\Luogu\P4782_2.cpp", "C++", 92, 0, 0, 0, 2, 26, 120
"d:\OI\Code\Luogu\P4861.cpp", "C++", 51, 0, 0, 0, 0, 11, 62
"d:\OI\Code\Luogu\P4876.cpp", "C++", 109, 0, 0, 0, 4, 33, 146
"d:\OI\Code\Luogu\P4884.cpp", "C++", 75, 0, 0, 0, 0, 17, 92
"d:\OI\Code\Luogu\P5019.cpp", "C++", 28, 0, 0, 0, 0, 12, 40
"d:\OI\Code\Luogu\P5043.cpp", "C++", 88, 0, 0, 0, 0, 34, 122
"d:\OI\Code\Luogu\P5047.cpp", "C++", 145, 0, 0, 0, 8, 44, 197
"d:\OI\Code\Luogu\P5067.cpp", "C++", 59, 0, 0, 0, 0, 4, 63
"d:\OI\Code\Luogu\P5192.cpp", "C++", 152, 0, 0, 0, 0, 43, 195
"d:\OI\Code\Luogu\P5239.cpp", "C++", 23, 0, 0, 0, 3, 11, 37
"d:\OI\Code\Luogu\P5278.cpp", "C++", 101, 0, 0, 0, 3, 25, 129
"d:\OI\Code\Luogu\P5283.cpp", "C++", 77, 0, 0, 0, 1, 29, 107
"d:\OI\Code\Luogu\P5303.cpp", "C++", 71, 0, 0, 0, 3, 23, 97
"d:\OI\Code\Luogu\P5304.cpp", "C++", 91, 0, 0, 0, 6, 33, 130
"d:\OI\Code\Luogu\P5309.cpp", "C++", 127, 0, 0, 0, 10, 32, 169
"d:\OI\Code\Luogu\P5410.cpp", "C++", 45, 0, 0, 0, 1, 14, 60
"d:\OI\Code\Luogu\P5436.cpp", "C++", 30, 0, 0, 0, 0, 9, 39
"d:\OI\Code\Luogu\P5443.cpp", "C++", 124, 0, 0, 0, 6, 40, 170
"d:\OI\Code\Luogu\P5459.cpp", "C++", 61, 0, 0, 0, 0, 22, 83
"d:\OI\Code\Luogu\P5482.cpp", "C++", 127, 0, 0, 0, 1, 29, 157
"d:\OI\Code\Luogu\P5490.cpp", "C++", 66, 0, 0, 0, 5, 25, 96
"d:\OI\Code\Luogu\P5490a.cpp", "C++", 64, 0, 0, 0, 0, 25, 89
"d:\OI\Code\Luogu\P5496.cpp", "C++", 59, 0, 0, 0, 0, 18, 77
"d:\OI\Code\Luogu\P5536.cpp", "C++", 69, 0, 0, 0, 0, 26, 95
"d:\OI\Code\Luogu\P5594.cpp", "C++", 32, 0, 0, 0, 0, 10, 42
"d:\OI\Code\Luogu\P5596.cpp", "C++", 38, 0, 0, 0, 0, 14, 52
"d:\OI\Code\Luogu\P5782.cpp", "C++", 87, 0, 0, 0, 3, 28, 118
"d:\OI\Code\Luogu\P5854.cpp", "C++", 50, 0, 0, 0, 3, 18, 71
"d:\OI\Code\Luogu\P5994.cpp", "C++", 66, 0, 0, 0, 0, 22, 88
"d:\OI\Code\Luogu\P6008.cpp", "C++", 68, 0, 0, 0, 3, 23, 94
"d:\OI\Code\Luogu\P6075.cpp", "C++", 35, 0, 0, 0, 3, 13, 51
"d:\OI\Code\Luogu\P6136.cpp", "C++", 107, 0, 0, 0, 0, 30, 137
"d:\OI\Code\Luogu\P6146.cpp", "C++", 66, 0, 0, 0, 3, 23, 92
"d:\OI\Code\Luogu\P6185.cpp", "C++", 115, 0, 0, 0, 5, 41, 161
"d:\OI\Code\Luogu\P6478.cpp", "C++", 115, 0, 0, 0, 1, 32, 148
"d:\OI\Code\Luogu\P6617.cpp", "C++", 101, 0, 0, 0, 3, 34, 138
"d:\OI\Code\Luogu\P6619.cpp", "C++", 113, 0, 0, 0, 0, 43, 156
"d:\OI\Code\Luogu\P6619_a.cpp", "C++", 102, 0, 0, 0, 0, 39, 141
"d:\OI\Code\Luogu\P6622_30pts.cpp", "C++", 43, 0, 0, 0, 0, 18, 61
"d:\OI\Code\Luogu\P6883.cpp", "C++", 58, 0, 0, 0, 0, 18, 76
"d:\OI\Code\Luogu\P7077.cpp", "C++", 128, 0, 0, 0, 1, 27, 156
"d:\OI\Code\Luogu\P7425.cpp", "C++", 204, 0, 0, 0, 0, 63, 267
"d:\OI\Code\Luogu\P7771.cpp", "C++", 62, 0, 0, 0, 0, 16, 78
"d:\OI\Code\Luogu\P7880.cpp", "C++", 150, 0, 0, 0, 4, 55, 209
"d:\OI\Code\Luogu\P7897.cpp", "C++", 134, 0, 0, 0, 4, 44, 182
"d:\OI\Code\Luogu\P7906.cpp", "C++", 114, 0, 0, 0, 24, 38, 176
"d:\OI\Code\Luogu\P7913.cpp", "C++", 82, 0, 0, 0, 2, 15, 99
"d:\OI\Code\Luogu\P7960.cpp", "C++", 76, 0, 0, 0, 2, 11, 89
"d:\OI\Code\Luogu\P8321.cpp", "C++", 60, 0, 0, 0, 3, 20, 83
"d:\OI\Code\Luogu\P8449.cpp", "C++", 66, 0, 0, 0, 0, 26, 92
"d:\OI\Code\Luogu\P8496.cpp", "C++", 143, 0, 0, 0, 0, 36, 179
"d:\OI\Code\Luogu\P8557.cpp", "C++", 36, 0, 0, 0, 3, 13, 52
"d:\OI\Code\Luogu\P8572.cpp", "C++", 68, 0, 0, 0, 4, 21, 93
"d:\OI\Code\Luogu\P8576DTOI.cpp", "C++", 149, 0, 0, 0, 3, 44, 196
"d:\OI\Code\Luogu\P8591.cpp", "C++", 67, 0, 0, 0, 1, 19, 87
"d:\OI\Code\Luogu\P8670.cpp", "C++", 16, 0, 0, 0, 0, 10, 26
"d:\OI\Code\Luogu\P8819.cpp", "C++", 72, 0, 0, 0, 0, 17, 89
"d:\OI\Code\Luogu\P8867.cpp", "C++", 123, 0, 0, 0, 2, 43, 168
"d:\OI\Code\Luogu\P8880.cpp", "C++", 31, 0, 0, 0, 0, 11, 42
"d:\OI\Code\Luogu\P8883.cpp", "C++", 26, 0, 0, 0, 0, 7, 33
"d:\OI\Code\Luogu\P9007.cpp", "C++", 100, 0, 0, 0, 2, 25, 127
"d:\OI\Code\Luogu\P9118.cpp", "C++", 89, 0, 0, 0, 1, 21, 111
"d:\OI\Code\Luogu\P9166.cpp", "C++", 75, 0, 0, 0, 0, 24, 99
"d:\OI\Code\Luogu\P9235.cpp", "C++", 152, 0, 0, 0, 12, 27, 191
"d:\OI\Code\Luogu\P9235_a.cpp", "C++", 168, 0, 0, 0, 0, 31, 199
"d:\OI\Code\Luogu\P9236.cpp", "C++", 48, 0, 0, 0, 0, 16, 64
"d:\OI\Code\Luogu\P9753.cpp", "C++", 37, 0, 0, 0, 0, 14, 51
"d:\OI\Code\Luogu\P9753_CSP-S.cpp", "C++", 64, 0, 0, 0, 21, 32, 117
"d:\OI\Code\Luogu\P9753_hash.cpp", "C++", 49, 0, 0, 0, 0, 18, 67
"d:\OI\Code\Luogu\P9869.cpp", "C++", 134, 0, 0, 0, 15, 45, 194
"d:\OI\Code\Luogu\P9869_1.cpp", "C++", 110, 0, 0, 0, 0, 38, 148
"d:\OI\Code\Luogu\P9963.cpp", "C++", 24, 0, 0, 0, 0, 8, 32
"d:\OI\Code\Luogu\SP1043.cpp", "C++", 63, 0, 0, 0, 0, 28, 91
"d:\OI\Code\Luogu\SP1716.cpp", "C++", 77, 0, 0, 0, 0, 31, 108
"d:\OI\Code\Luogu\SP1805.cpp", "C++", 46, 0, 0, 0, 3, 20, 69
"d:\OI\Code\Luogu\SP2713.cpp", "C++", 80, 0, 0, 0, 0, 30, 110
"d:\OI\Code\Luogu\SP2916.cpp", "C++", 82, 0, 0, 0, 1, 34, 117
"d:\OI\Code\Luogu\SP3267.cpp", "C++", 56, 0, 0, 0, 0, 25, 81
"d:\OI\Code\Luogu\SP6779.cpp", "C++", 172, 0, 0, 0, 0, 64, 236
"d:\OI\Code\Luogu\SP7826.cpp", "C++", 93, 0, 0, 0, 0, 28, 121
"d:\OI\Code\Luogu\SP8177.cpp", "C++", 4, 0, 0, 0, 2, 1, 7
"d:\OI\Code\Luogu\UVA10480.cpp", "C++", 121, 0, 0, 0, 1, 29, 151
"d:\OI\Code\Luogu\UVA10891.cpp", "C++", 55, 0, 0, 0, 0, 17, 72
"d:\OI\Code\Luogu\UVA11021.cpp", "C++", 47, 0, 0, 0, 0, 16, 63
"d:\OI\Code\Luogu\UVA11082.cpp", "C++", 129, 0, 0, 0, 0, 33, 162
"d:\OI\Code\Luogu\UVA11424.cpp", "C++", 20, 0, 0, 0, 0, 14, 34
"d:\OI\Code\Luogu\UVA12983.cpp", "C++", 60, 0, 0, 0, 1, 22, 83
"d:\OI\Code\Luogu\UVA1316.cpp", "C++", 42, 0, 0, 0, 3, 16, 61
"d:\OI\Code\Luogu\beta202404G.cpp", "C++", 57, 0, 0, 0, 0, 26, 83
"d:\OI\Code\TodoList\2023_CSP-S_T2.cpp", "C++", 39, 0, 0, 0, 2, 17, 58
"d:\OI\Code\TodoList\2023_zr_noip_1_C.cpp", "C++", 61, 0, 0, 0, 0, 24, 85
"d:\OI\Code\TodoList\CF1307D.cpp", "C++", 93, 0, 0, 0, 3, 31, 127
"d:\OI\Code\TodoList\F.cpp", "C++", 62, 0, 0, 0, 10, 24, 96
"d:\OI\Code\TodoList\FenwickTreeWithSegmentTree.cpp", "C++", 116, 0, 0, 0, 0, 41, 157
"d:\OI\Code\TodoList\P1600.cpp", "C++", 164, 0, 0, 0, 8, 34, 206
"d:\OI\Code\TodoList\P2304.cpp", "C++", 158, 0, 0, 0, 1, 48, 207
"d:\OI\Code\TodoList\P2387.cpp", "C++", 105, 0, 0, 0, 0, 36, 141
"d:\OI\Code\TodoList\P5482.cpp", "C++", 127, 0, 0, 0, 1, 29, 157
"d:\OI\Code\TodoList\csp-j2022-sd-bs.cpp", "C++", 59, 0, 0, 0, 0, 19, 78
"d:\OI\Code\TodoList\dfz.cpp", "C++", 57, 0, 0, 0, 0, 21, 78
"d:\OI\Code\TodoList\fhq_treap.cpp", "C++", 119, 0, 0, 0, 8, 21, 148
"d:\OI\Code\TodoList\segTree_merge.cpp", "C++", 117, 0, 0, 0, 0, 0, 117
"d:\OI\Code\TodoList\segTree_mod.cpp", "C++", 98, 0, 0, 0, 11, 1, 110
"d:\OI\Code\TodoList\segTree_mod_me.cpp", "C++", 81, 0, 0, 0, 0, 20, 101
"d:\OI\Code\UOJ\228.cpp", "C++", 140, 0, 0, 0, 1, 40, 181
"d:\OI\Code\UOJ\63.cpp", "C++", 65, 0, 0, 0, 0, 27, 92
"d:\OI\Code\UOJ\763.cpp", "C++", 65, 0, 0, 0, 0, 24, 89
"d:\OI\Code\cp-archive.py", "Python", 0, 122, 0, 0, 0, 21, 143
"d:\OI\Code\fsan.sh", "Shell Script", 0, 0, 1, 0, 0, 0, 1
"d:\OI\Code\make.py", "Python", 0, 108, 0, 0, 0, 20, 128
"d:\OI\Code\model.cpp", "C++", 24, 0, 0, 0, 4, 13, 41
"d:\OI\Code\std.cpp", "C++", 106, 0, 0, 0, 21, 3, 130
"d:\OI\Code\temp.cpp", "C++", 24, 0, 0, 0, 4, 13, 41
"Total", "-", 76799, 307, 1, 22, 502343, 23049, 602521