"filename", "language", "C++", "Python", "Markdown", "comment", "blank", "total"
"d:\000 Noip\000 Code\Comp\22-11-13 洛谷NOIP全程模拟\A.cpp", "C++", 29, 0, 0, 0, 7, 36
"d:\000 Noip\000 Code\Comp\22-11-13 洛谷NOIP全程模拟\A_1.cpp", "C++", 37, 0, 0, 0, 4, 41
"d:\000 Noip\000 Code\Comp\22-11-13 洛谷NOIP全程模拟\A_2.cpp", "C++", 61, 0, 0, 5, 14, 80
"d:\000 Noip\000 Code\Comp\22-11-13 洛谷NOIP全程模拟\A_3.cpp", "C++", 29, 0, 0, 0, 7, 36
"d:\000 Noip\000 Code\Comp\22-11-13 洛谷NOIP全程模拟\B.cpp", "C++", 129, 0, 0, 10, 18, 157
"d:\000 Noip\000 Code\Comp\22-11-13 洛谷NOIP全程模拟\B_1.cpp", "C++", 49, 0, 0, 0, 9, 58
"d:\000 Noip\000 Code\Comp\22-11-18 sg模拟\A.cpp", "C++", 52, 0, 0, 1, 13, 66
"d:\000 Noip\000 Code\Comp\22-11-18 sg模拟\A2.cpp", "C++", 217, 0, 0, 0, 4, 221
"d:\000 Noip\000 Code\Comp\22-11-18 sg模拟\A_py.py", "Python", 0, 4, 0, 0, 1, 5
"d:\000 Noip\000 Code\Comp\22-11-18 sg模拟\A_table.cpp", "C++", 21, 0, 0, 1, 6, 28
"d:\000 Noip\000 Code\Comp\22-11-18 sg模拟\C.cpp", "C++", 86, 0, 0, 1, 14, 101
"d:\000 Noip\000 Code\Comp\22-11-19 LGR2\A.cpp", "C++", 14, 0, 0, 0, 5, 19
"d:\000 Noip\000 Code\Comp\22-11-19 LGR2\B.cpp", "C++", 52, 0, 0, 0, 12, 64
"d:\000 Noip\000 Code\Comp\22-11-19 LGR2\C.cpp", "C++", 73, 0, 0, 0, 10, 83
"d:\000 Noip\000 Code\Comp\22-11-19 LGR2\C_1.cpp", "C++", 13, 0, 0, 0, 4, 17
"d:\000 Noip\000 Code\Comp\22-11-19 LGR2\C_2.cpp", "C++", 35, 0, 0, 0, 7, 42
"d:\000 Noip\000 Code\Comp\22-11-19 LGR2\C_debug.cpp", "C++", 73, 0, 0, 0, 11, 84
"d:\000 Noip\000 Code\Comp\22-11-19 LGR2\test.cpp", "C++", 15, 0, 0, 0, 4, 19
"d:\000 Noip\000 Code\Comp\22-11-19 LGR2\赛后\A.cpp", "C++", 83, 0, 0, 2, 14, 99
"d:\000 Noip\000 Code\Comp\22-11-19 LGR\A.cpp", "C++", 45, 0, 0, 0, 7, 52
"d:\000 Noip\000 Code\Comp\22-11-19 LGR\B.cpp", "C++", 16, 0, 0, 0, 5, 21
"d:\000 Noip\000 Code\Comp\22-11-19 LGR\C.cpp", "C++", 77, 0, 0, 0, 12, 89
"d:\000 Noip\000 Code\Comp\22-11-19 LGR\D.cpp", "C++", 117, 0, 0, 1, 18, 136
"d:\000 Noip\000 Code\Comp\22-11-19 LGR\D_sub2.cpp", "C++", 127, 0, 0, 0, 17, 144
"d:\000 Noip\000 Code\Comp\22-11-19 LGR\test.cpp", "C++", 10, 0, 0, 0, 5, 15
"d:\000 Noip\000 Code\Comp\22-11-20 luogu模拟\A.cpp", "C++", 29, 0, 0, 0, 8, 37
"d:\000 Noip\000 Code\Comp\22-11-20 sg模拟-J\D.cpp", "C++", 41, 0, 0, 0, 12, 53
"d:\000 Noip\000 Code\Comp\22-11-20 sg模拟-S\A.cpp", "C++", 48, 0, 0, 0, 15, 63
"d:\000 Noip\000 Code\Comp\22-11-20 sg模拟-S\C.cpp", "C++", 17, 0, 0, 0, 4, 21
"d:\000 Noip\000 Code\Comp\22-11-20 sg模拟-S\D.cpp", "C++", 91, 0, 0, 4, 17, 112
"d:\000 Noip\000 Code\Comp\22-11-20 sg模拟-S\D_1.cpp", "C++", 103, 0, 0, 22, 16, 141
"d:\000 Noip\000 Code\Comp\22-11-20 sg模拟-S\D_debug.cpp", "C++", 76, 0, 0, 11, 15, 102
"d:\000 Noip\000 Code\Comp\22-11-20 sg模拟-S\test.cpp", "C++", 15, 0, 0, 0, 4, 19
"d:\000 Noip\000 Code\Comp\22-11-21 coding c++\A.cpp", "C++", 17, 0, 0, 0, 4, 21
"d:\000 Noip\000 Code\Comp\22-11-21 coding c++\Acw1.cpp", "C++", 15, 0, 0, 0, 6, 21
"d:\000 Noip\000 Code\Comp\22-11-21 coding c++\B.cpp", "C++", 15, 0, 0, 0, 4, 19
"d:\000 Noip\000 Code\Comp\22-11-21 coding c++\G.cpp", "C++", 24, 0, 0, 0, 9, 33
"d:\000 Noip\000 Code\Comp\22-11-21 coding c++\M.cpp", "C++", 16, 0, 0, 0, 6, 22
"d:\000 Noip\000 Code\Comp\22-11-21 coding c++\T.cpp", "C++", 19, 0, 0, 0, 4, 23
"d:\000 Noip\000 Code\Comp\22-11-21 coding c++\V.cpp", "C++", 15, 0, 0, 0, 4, 19
"d:\000 Noip\000 Code\Comp\22-11-21 coding c++\W.cpp", "C++", 19, 0, 0, 0, 4, 23
"d:\000 Noip\000 Code\Comp\22-11-21 sg模拟-J\A.cpp", "C++", 69, 0, 0, 0, 12, 81
"d:\000 Noip\000 Code\Comp\22-11-21 sg模拟-J\B.cpp", "C++", 37, 0, 0, 0, 9, 46
"d:\000 Noip\000 Code\Comp\22-11-21 sg模拟-J\C.cpp", "C++", 36, 0, 0, 0, 7, 43
"d:\000 Noip\000 Code\Comp\22-11-21 sg模拟-J\D.cpp", "C++", 16, 0, 0, 0, 5, 21
"d:\000 Noip\000 Code\Comp\22-11-21 sg模拟-S\B.cpp", "C++", 14, 0, 0, 0, 7, 21
"d:\000 Noip\000 Code\Comp\22-11-21 sg模拟-S\C.cpp", "C++", 16, 0, 0, 0, 6, 22
"d:\000 Noip\000 Code\Comp\22-11-22 coding c++\A.cpp", "C++", 17, 0, 0, 0, 6, 23
"d:\000 Noip\000 Code\Comp\22-11-22 coding c++\B.cpp", "C++", 20, 0, 0, 0, 6, 26
"d:\000 Noip\000 Code\Comp\22-11-22 coding c++\C.cpp", "C++", 59, 0, 0, 4, 9, 72
"d:\000 Noip\000 Code\Comp\22-11-22 coding c++\D.cpp", "C++", 21, 0, 0, 0, 7, 28
"d:\000 Noip\000 Code\Comp\22-11-22 coding c++\aaaaa.cpp", "C++", 14, 0, 0, 0, 5, 19
"d:\000 Noip\000 Code\Comp\22-11-22 sg模拟-J\A.cpp", "C++", 43, 0, 0, 0, 9, 52
"d:\000 Noip\000 Code\Comp\22-11-22 sg模拟-J\B.cpp", "C++", 31, 0, 0, 6, 9, 46
"d:\000 Noip\000 Code\Comp\22-11-22 sg模拟-J\C.cpp", "C++", 60, 0, 0, 6, 5, 71
"d:\000 Noip\000 Code\Comp\22-11-22 sg模拟-J\C2.cpp", "C++", 0, 0, 0, 0, 2, 2
"d:\000 Noip\000 Code\Comp\22-11-22 sg模拟-S\A.cpp", "C++", 14, 0, 0, 0, 5, 19
"d:\000 Noip\000 Code\Comp\22-11-22 sg模拟-S\B.cpp", "C++", 47, 0, 0, 0, 13, 60
"d:\000 Noip\000 Code\Comp\22-11-22 sg模拟-S\C.cpp", "C++", 80, 0, 0, 0, 14, 94
"d:\000 Noip\000 Code\Comp\22-11-22 sg模拟-S\C1.cpp", "C++", 107, 0, 0, 4, 17, 128
"d:\000 Noip\000 Code\Comp\22-11-23 coding c++\A.cpp", "C++", 67, 0, 0, 0, 12, 79
"d:\000 Noip\000 Code\Comp\22-11-23 coding c++\B.cpp", "C++", 53, 0, 0, 0, 10, 63
"d:\000 Noip\000 Code\Comp\22-11-23 coding c++\C.cpp", "C++", 15, 0, 0, 0, 4, 19
"d:\000 Noip\000 Code\Comp\22-11-23 coding c++\D.cpp", "C++", 99, 0, 0, 5, 16, 120
"d:\000 Noip\000 Code\Comp\22-11-23 coding c++\OLE.cpp", "C++", 18, 0, 0, 0, 4, 22
"d:\000 Noip\000 Code\Comp\22-11-23 sg模拟-J\A.cpp", "C++", 85, 0, 0, 0, 12, 97
"d:\000 Noip\000 Code\Comp\22-11-23 sg模拟-J\B.cpp", "C++", 14, 0, 0, 0, 5, 19
"d:\000 Noip\000 Code\Comp\22-11-23 sg模拟-J\D.cpp", "C++", 78, 0, 0, 0, 13, 91
"d:\000 Noip\000 Code\Comp\22-11-23 sg模拟-J\P11.cpp", "C++", 27, 0, 0, 0, 5, 32
"d:\000 Noip\000 Code\Comp\22-11-23 sg模拟-J\P13.cpp", "C++", 33, 0, 0, 2, 7, 42
"d:\000 Noip\000 Code\Comp\22-11-23 sg模拟-S\A.cpp", "C++", 84, 0, 0, 0, 17, 101
"d:\000 Noip\000 Code\Comp\22-11-23 sg模拟-S\A1.cpp", "C++", 14, 0, 0, 0, 5, 19
"d:\000 Noip\000 Code\Comp\22-11-23 sg模拟-S\test.cpp", "C++", 7, 0, 0, 0, 1, 8
"d:\000 Noip\000 Code\Comp\22-11-25 sg模拟-J\D.cpp", "C++", 74, 0, 0, 17, 6, 97
"d:\000 Noip\000 Code\Comp\22-11-25 sg模拟-J\abc.cpp", "C++", 14, 0, 0, 0, 5, 19
"d:\000 Noip\000 Code\Comp\22-11-26 noip2022\barrack.cpp", "C++", 103, 0, 0, 2, 15, 120
"d:\000 Noip\000 Code\Comp\22-11-26 noip2022\match.cpp", "C++", 82, 0, 0, 6, 11, 99
"d:\000 Noip\000 Code\Comp\22-11-26 noip2022\noip2022.md", "Markdown", 0, 0, 18, 0, 18, 36
"d:\000 Noip\000 Code\Comp\22-11-26 noip2022\plant.cpp", "C++", 261, 0, 0, 79, 22, 362
"d:\000 Noip\000 Code\Comp\22-11-26 noip2022\曹天朗SD-867\曹天朗SD-867\match\match - 副本.cpp", "C++", 82, 0, 0, 6, 11, 99
"d:\000 Noip\000 Code\Comp\22-11-26 noip2022\曹天朗SD-867\曹天朗SD-867\match\match.cpp", "C++", 86, 0, 0, 2, 11, 99
"d:\000 Noip\000 Code\Comp\22-11-26 noip2022\曹天朗SD-867\曹天朗SD-867\plant\plant.cpp", "C++", 252, 0, 0, 82, 25, 359
"d:\000 Noip\000 Code\Comp\23-01-14 蓝桥杯test\A.cpp", "C++", 17, 0, 0, 0, 5, 22
"d:\000 Noip\000 Code\Comp\23-01-14 蓝桥杯test\B.cpp", "C++", 24, 0, 0, 0, 4, 28
"d:\000 Noip\000 Code\Comp\23-01-15 蓝桥杯\1\1.cpp", "C++", 12, 0, 0, 0, 3, 15
"d:\000 Noip\000 Code\Comp\23-01-15 蓝桥杯\1\1_a.cpp", "C++", 14, 0, 0, 0, 3, 17
"d:\000 Noip\000 Code\Comp\23-01-15 蓝桥杯\1\1_duipai.cpp", "C++", 9, 0, 0, 0, 3, 12
"d:\000 Noip\000 Code\Comp\23-01-15 蓝桥杯\2\2.cpp", "C++", 44, 0, 0, 0, 6, 50
"d:\000 Noip\000 Code\Comp\23-01-15 蓝桥杯\3\3.cpp", "C++", 53, 0, 0, 0, 10, 63
"d:\000 Noip\000 Code\Comp\23-01-15 蓝桥杯\4\4.cpp", "C++", 95, 0, 0, 0, 13, 108
"d:\000 Noip\000 Code\Comp\23-01-15 蓝桥杯\5\5.cpp", "C++", 51, 0, 0, 0, 8, 59
"d:\000 Noip\000 Code\Comp\23-01-15 蓝桥杯\5\5_a.cpp", "C++", 70, 0, 0, 0, 10, 80
"d:\000 Noip\000 Code\Comp\23-02-02 sg测试\A.cpp", "C++", 41, 0, 0, 0, 11, 52
"d:\000 Noip\000 Code\Comp\23-02-02 sg测试\B.cpp", "C++", 32, 0, 0, 0, 9, 41
"d:\000 Noip\000 Code\Comp\23-02-02 sg测试\C.cpp", "C++", 50, 0, 0, 0, 11, 61
"d:\000 Noip\000 Code\Comp\23-02-02 sg测试\D.cpp", "C++", 45, 0, 0, 0, 11, 56
"d:\000 Noip\000 Code\Comp\23-02-04 sg测试\A.cpp", "C++", 24, 0, 0, 0, 8, 32
"d:\000 Noip\000 Code\Comp\23-02-04 sg测试\B.cpp", "C++", 82, 0, 0, 0, 13, 95
"d:\000 Noip\000 Code\Comp\23-02-04 sg测试\D.cpp", "C++", 68, 0, 0, 0, 11, 79
"d:\000 Noip\000 Code\Comp\23-04-29 ABC\A.cpp", "C++", 31, 0, 0, 0, 9, 40
"d:\000 Noip\000 Code\Comp\23-04-29 ABC\B.cpp", "C++", 90, 0, 0, 2, 15, 107
"d:\000 Noip\000 Code\Comp\23-04-29 CF869\A.cpp", "C++", 51, 0, 0, 0, 14, 65
"d:\000 Noip\000 Code\Comp\23-05-01 LG\A.cpp", "C++", 16, 0, 0, 0, 6, 22
"d:\000 Noip\000 Code\Comp\23-05-01 LG\E.cpp", "C++", 51, 0, 0, 0, 12, 63
"d:\000 Noip\000 Code\Comp\23-05-01 LG\E_Table\Table1.cpp", "C++", 55, 0, 0, 0, 13, 68
"d:\000 Noip\000 Code\Comp\23-05-01 LG\E_Table\Table10.cpp", "C++", 55, 0, 0, 0, 13, 68
"d:\000 Noip\000 Code\Comp\23-05-01 LG\E_Table\Table2.cpp", "C++", 54, 0, 0, 0, 13, 67
"d:\000 Noip\000 Code\Comp\23-05-01 LG\E_Table\Table3.cpp", "C++", 54, 0, 0, 0, 13, 67
"d:\000 Noip\000 Code\Comp\23-05-01 LG\E_Table\Table4.cpp", "C++", 54, 0, 0, 0, 13, 67
"d:\000 Noip\000 Code\Comp\23-05-01 LG\E_Table\Table5.cpp", "C++", 54, 0, 0, 0, 13, 67
"d:\000 Noip\000 Code\Comp\23-05-01 LG\E_Table\Table6.cpp", "C++", 54, 0, 0, 0, 13, 67
"d:\000 Noip\000 Code\Comp\23-05-01 LG\E_Table\Table7.cpp", "C++", 54, 0, 0, 0, 13, 67
"d:\000 Noip\000 Code\Comp\23-05-01 LG\E_Table\Table8.cpp", "C++", 54, 0, 0, 0, 13, 67
"d:\000 Noip\000 Code\Comp\23-05-01 LG\E_Table\Table9.cpp", "C++", 54, 0, 0, 0, 13, 67
"d:\000 Noip\000 Code\Comp\23-05-01 LG\E_fast.cpp", "C++", 22, 0, 0, 0, 9, 31
"d:\000 Noip\000 Code\Comp\23-05-01 LG\E_table.cpp", "C++", 56, 0, 0, 0, 12, 68
"d:\000 Noip\000 Code\Comp\23-05-01 LG\Table_host.cpp", "C++", 14, 0, 0, 0, 5, 19
"d:\000 Noip\000 Code\Comp\23-05-14 蓝桥杯\A.cpp", "C++", 18, 0, 0, 0, 7, 25
"d:\000 Noip\000 Code\Comp\23-05-14 蓝桥杯\B.cpp", "C++", 39, 0, 0, 0, 11, 50
"d:\000 Noip\000 Code\Comp\23-05-14 蓝桥杯\C.cpp", "C++", 38, 0, 0, 0, 8, 46
"d:\000 Noip\000 Code\Comp\23-05-14 蓝桥杯\D.cpp", "C++", 36, 0, 0, 0, 11, 47
"d:\000 Noip\000 Code\Comp\23-05-14 蓝桥杯\E.cpp", "C++", 47, 0, 0, 0, 12, 59
"d:\000 Noip\000 Code\Comp\23-05-14 蓝桥杯\E2.cpp", "C++", 84, 0, 0, 4, 24, 112
"d:\000 Noip\000 Code\Comp\23-05-14 蓝桥杯\test\A.cpp", "C++", 17, 0, 0, 0, 5, 22
"d:\000 Noip\000 Code\Comp\23-05-14 蓝桥杯\test\B.cpp", "C++", 17, 0, 0, 0, 5, 22
"d:\000 Noip\000 Code\Comp\23-05-28 LG\A.cpp", "C++", 31, 0, 0, 0, 7, 38
"d:\000 Noip\000 Code\Comp\23-05-28 蓝桥杯国赛\A.cpp", "C++", 44, 0, 0, 0, 9, 53
"d:\000 Noip\000 Code\Comp\23-05-28 蓝桥杯国赛\B.cpp", "C++", 33, 0, 0, 0, 8, 41
"d:\000 Noip\000 Code\Comp\23-05-28 蓝桥杯国赛\C.cpp", "C++", 89, 0, 0, 4, 14, 107
"d:\000 Noip\000 Code\Comp\23-05-28 蓝桥杯国赛\D.cpp", "C++", 14, 0, 0, 0, 5, 19
"d:\000 Noip\000 Code\Comp\23-05-28 蓝桥杯国赛\E.cpp", "C++", 47, 0, 0, 0, 11, 58
"d:\000 Noip\000 Code\Comp\23-05-28 蓝桥杯国赛\F.cpp", "C++", 39, 0, 0, 0, 10, 49
"d:\000 Noip\000 Code\Comp\23-06-11 夏令营\A.cpp", "C++", 126, 0, 0, 1, 22, 149
"d:\000 Noip\000 Code\Comp\23-06-11 夏令营\B.cpp", "C++", 28, 0, 0, 0, 8, 36
"d:\000 Noip\000 Code\Comp\23-07-07 CF883\A.cpp", "C++", 39, 0, 0, 0, 8, 47
"d:\000 Noip\000 Code\Comp\23-07-07 CF883\B.cpp", "C++", 83, 0, 0, 0, 14, 97
"d:\000 Noip\000 Code\Comp\23-07-07 CF883\C.cpp", "C++", 74, 0, 0, 8, 22, 104
"d:\000 Noip\000 Code\Comp\23-07-08 LG\A.cpp", "C++", 39, 0, 0, 0, 9, 48
"d:\000 Noip\000 Code\Comp\23-07-08 LG\B.cpp", "C++", 66, 0, 0, 0, 11, 77
"d:\000 Noip\000 Code\Comp\23-07-09 ARC\A.cpp", "C++", 34, 0, 0, 0, 10, 44
"d:\000 Noip\000 Code\Comp\23-07-14 LG\A.cpp", "C++", 18, 0, 0, 0, 7, 25
"d:\000 Noip\000 Code\Comp\23-07-14 LG\B.cpp", "C++", 37, 0, 0, 0, 12, 49
"d:\000 Noip\000 Code\Comp\23-07-14 LG\C.cpp", "C++", 50, 0, 0, 0, 11, 61
"d:\000 Noip\000 Code\Comp\23-07-14 LG\C_1.cpp", "C++", 14, 0, 0, 0, 5, 19
"d:\000 Noip\000 Code\Comp\23-07-14 LG\D.cpp", "C++", 17, 0, 0, 0, 8, 25
"d:\000 Noip\000 Code\Comp\23-07-14 LG\E.cpp", "C++", 66, 0, 0, 1, 14, 81
"d:\000 Noip\000 Code\Comp\23-07-14 LG\F.cpp", "C++", 66, 0, 0, 1, 14, 81
"d:\000 Noip\000 Code\Comp\23-07-15 ABC\A.cpp", "C++", 28, 0, 0, 0, 12, 40
"d:\000 Noip\000 Code\Comp\23-07-15 ABC\B.cpp", "C++", 56, 0, 0, 0, 14, 70
"d:\000 Noip\000 Code\Comp\23-07-21 CF 886\A.cpp", "C++", 13, 0, 0, 0, 8, 21
"d:\000 Noip\000 Code\Comp\23-07-21 CF 886\B.cpp", "C++", 22, 0, 0, 0, 8, 30
"d:\000 Noip\000 Code\Comp\23-07-21 CF 886\C.cpp", "C++", 25, 0, 0, 0, 10, 35
"d:\000 Noip\000 Code\Comp\23-07-21 CF 886\D.cpp", "C++", 31, 0, 0, 0, 14, 45
"d:\000 Noip\000 Code\Comp\23-07-21 CF 886\E.cpp", "C++", 0, 0, 0, 0, 1, 1
"d:\000 Noip\000 Code\Comp\23-07-21 CF 886\F.cpp", "C++", 29, 0, 0, 1, 15, 45
"d:\000 Noip\000 Code\Comp\23-07-21 CF 886\G.cpp", "C++", 0, 0, 0, 0, 1, 1
"d:\000 Noip\000 Code\Comp\23-07-21 CF 886\H.cpp", "C++", 0, 0, 0, 0, 1, 1
"d:\000 Noip\000 Code\Comp\23-07-21 CF 886\tempCodeRunnerFile.py", "Python", 0, 0, 0, 0, 1, 1
"d:\000 Noip\000 Code\Comp\23-07-21 CF 886\test.py", "Python", 0, 59, 0, 1, 23, 83
"d:\000 Noip\000 Code\Comp\23-07-22 ABC311\A_First_ABC.cpp", "C++", 29, 0, 0, 0, 9, 38
"d:\000 Noip\000 Code\Comp\23-07-22 ABC311\B_Vacation_Together.cpp", "C++", 38, 0, 0, 0, 13, 51
"d:\000 Noip\000 Code\Comp\23-07-22 ABC311\C_Find_it.cpp", "C++", 55, 0, 0, 1, 15, 71
"d:\000 Noip\000 Code\Comp\23-07-22 ABC311\D_Grid_Ice_Floor.cpp", "C++", 65, 0, 0, 0, 23, 88
"d:\000 Noip\000 Code\Comp\23-07-22 LG\T_309754_yLOI_2022_枕万梦.cpp", "C++", 39, 0, 0, 0, 13, 52
"d:\000 Noip\000 Code\Comp\23-07-22 LG\T_348565_yLOI_2022_长安幻世绘.cpp", "C++", 120, 0, 0, 3, 38, 161
"d:\000 Noip\000 Code\Comp\23-07-22 LG\T_349349_yLOI_2022_西施江南.cpp", "C++", 89, 0, 0, 4, 30, 123
"d:\000 Noip\000 Code\Comp\23-07-22 LG\T_349358_yLOI_2022_签到题.cpp", "C++", 28, 0, 0, 0, 9, 37
"d:\000 Noip\000 Code\Comp\23-07-23 ZR\A.cpp", "C++", 96, 0, 0, 15, 26, 137
"d:\000 Noip\000 Code\Comp\23-07-23 ZR\A_2.cpp", "C++", 49, 0, 0, 0, 12, 61
"d:\000 Noip\000 Code\Comp\23-07-23 ZR\B.cpp", "C++", 51, 0, 0, 0, 17, 68
"d:\000 Noip\000 Code\Comp\23-07-23 ZR\C.cpp", "C++", 35, 0, 0, 0, 13, 48
"d:\000 Noip\000 Code\Comp\23-07-23 ZR\Redo\A.cpp", "C++", 55, 0, 0, 3, 21, 79
"d:\000 Noip\000 Code\Comp\23-07-23 ZR\Redo\temp.cpp", "C++", 6, 0, 0, 0, 3, 9
"d:\000 Noip\000 Code\Comp\23-07-25 CF\1851D.cpp", "C++", 47, 0, 0, 2, 20, 69
"d:\000 Noip\000 Code\Comp\23-07-25 CF\Escalator_Conversations.cpp", "C++", 32, 0, 0, 0, 10, 42
"d:\000 Noip\000 Code\Comp\23-07-25 CF\Parity_Sort.cpp", "C++", 47, 0, 0, 0, 15, 62
"d:\000 Noip\000 Code\Comp\23-07-28 ZR ACM\A.cpp", "C++", 19, 0, 0, 0, 6, 25
"d:\000 Noip\000 Code\Comp\23-07-28 ZR ACM\B.cpp", "C++", 32, 0, 0, 1, 4, 37
"d:\000 Noip\000 Code\Comp\23-07-28 ZR ACM\C.cpp", "C++", 46, 0, 0, 0, 4, 50
"d:\000 Noip\000 Code\Comp\23-07-28 ZR ACM\D.cpp", "C++", 19, 0, 0, 0, 6, 25
"d:\000 Noip\000 Code\Comp\23-07-28 ZR ACM\E.cpp", "C++", 28, 0, 0, 0, 5, 33
"d:\000 Noip\000 Code\Comp\23-07-28 ZR ACM\F.cpp", "C++", 50, 0, 0, 15, 8, 73
"d:\000 Noip\000 Code\Comp\23-07-28 ZR ACM\F2.cpp", "C++", 61, 0, 0, 0, 22, 83
"d:\000 Noip\000 Code\Comp\23-07-28 ZR ACM\G.cpp", "C++", 61, 0, 0, 1, 7, 69
"d:\000 Noip\000 Code\Comp\23-07-28 ZR ACM\H.cpp", "C++", 19, 0, 0, 0, 6, 25
"d:\000 Noip\000 Code\Comp\23-07-28 ZR ACM\I.cpp", "C++", 90, 0, 0, 4, 20, 114
"d:\000 Noip\000 Code\Comp\23-07-28 ZR ACM\J.cpp", "C++", 86, 0, 0, 13, 3, 102
"d:\000 Noip\000 Code\Comp\23-07-28 ZR ACM\K.cpp", "C++", 24, 0, 0, 0, 7, 31
"d:\000 Noip\000 Code\Comp\23-07-28 ZR ACM\L.cpp", "C++", 19, 0, 0, 0, 6, 25
"d:\000 Noip\000 Code\Comp\23-07-28 ZR ACM\M.cpp", "C++", 19, 0, 0, 0, 6, 25
"d:\000 Noip\000 Code\Comp\23-07-28 ZR ACM\model.cpp", "C++", 19, 0, 0, 0, 6, 25
"d:\000 Noip\000 Code\Comp\23-07-28 ZR ACM\qwq.cpp", "C++", 29, 0, 0, 0, 5, 34
"d:\000 Noip\000 Code\Comp\23-07-28 ZR ACM\qwq2.cpp", "C++", 59, 0, 0, 29, 7, 95
"d:\000 Noip\000 Code\Comp\23-07-28 ZR ACM\未命名2.cpp", "C++", 26, 0, 0, 0, 4, 30
"d:\000 Noip\000 Code\Comp\23-07-28 ZR ACM\未命名3.cpp", "C++", 14, 0, 0, 0, 5, 19
"d:\000 Noip\000 Code\Comp\23-07-29 ABC312\A.cpp", "C++", 13, 0, 0, 0, 5, 18
"d:\000 Noip\000 Code\Comp\23-07-29 ABC312\B.cpp", "C++", 46, 0, 0, 2, 21, 69
"d:\000 Noip\000 Code\Comp\23-07-29 ABC312\C.cpp", "C++", 33, 0, 0, 5, 16, 54
"d:\000 Noip\000 Code\Comp\23-08-02 ZR\A.cpp", "C++", 70, 0, 0, 0, 23, 93
"d:\000 Noip\000 Code\Comp\23-08-02 ZR\B.cpp", "C++", 43, 0, 0, 0, 13, 56
"d:\000 Noip\000 Code\Comp\23-08-02 ZR\C.cpp", "C++", 27, 0, 0, 0, 9, 36
"d:\000 Noip\000 Code\Comp\23-08-02 ZR\PaiA\code.cpp", "C++", 65, 0, 0, 0, 20, 85
"d:\000 Noip\000 Code\Comp\23-08-02 ZR\PaiA\pai.cpp", "C++", 25, 0, 0, 0, 9, 34
"d:\000 Noip\000 Code\Comp\23-08-02 ZR\PaiA\scode.cpp", "C++", 73, 0, 0, 1, 14, 88
"d:\000 Noip\000 Code\Comp\23-08-04 ZR\A.cpp", "C++", 25, 0, 0, 0, 10, 35
"d:\000 Noip\000 Code\Comp\23-08-04 ZR\B.cpp", "C++", 50, 0, 0, 4, 19, 73
"d:\000 Noip\000 Code\Comp\23-08-04 ZR\B_1.cpp", "C++", 64, 0, 0, 1, 19, 84
"d:\000 Noip\000 Code\Comp\23-08-04 ZR\C.cpp", "C++", 27, 0, 0, 0, 5, 32
"d:\000 Noip\000 Code\Comp\23-08-04 ZR\cc.cpp", "C++", 52, 0, 0, 0, 12, 64
"d:\000 Noip\000 Code\Comp\23-08-04 ZR\d.cpp", "C++", 17, 0, 0, 0, 7, 24
"d:\000 Noip\000 Code\Comp\23-08-05 ABC313\A.cpp", "C++", 33, 0, 0, 0, 13, 46
"d:\000 Noip\000 Code\Comp\23-08-05 ABC313\B.cpp", "C++", 36, 0, 0, 0, 10, 46
"d:\000 Noip\000 Code\Comp\23-08-05 ABC313\C.cpp", "C++", 36, 0, 0, 0, 13, 49
"d:\000 Noip\000 Code\Comp\23-08-05 ABC313\D.cpp", "C++", 32, 0, 0, 1, 12, 45
"d:\000 Noip\000 Code\Comp\23-08-08 ZR\A.cpp", "C++", 36, 0, 0, 0, 14, 50
"d:\000 Noip\000 Code\Comp\23-08-08 ZR\B.cpp", "C++", 0, 0, 0, 0, 1, 1
"d:\000 Noip\000 Code\Comp\23-08-08 ZR\C.cpp", "C++", 83, 0, 0, 3, 28, 114
"d:\000 Noip\000 Code\Comp\23-08-08 ZR\test.cpp", "C++", 20, 0, 0, 0, 10, 30
"d:\000 Noip\000 Code\Comp\23-08-12 ABC314\A.cpp", "C++", 12, 0, 0, 0, 6, 18
"d:\000 Noip\000 Code\Comp\23-08-12 ABC314\B.cpp", "C++", 33, 0, 0, 0, 10, 43
"d:\000 Noip\000 Code\Comp\23-08-12 ABC314\D.cpp", "C++", 38, 0, 0, 17, 12, 67
"d:\000 Noip\000 Code\Comp\23-08-12 ABC314\D_1.cpp", "C++", 45, 0, 0, 0, 9, 54
"d:\000 Noip\000 Code\Comp\23-08-12 ABC314\test.cpp", "C++", 6, 0, 0, 0, 4, 10
"d:\000 Noip\000 Code\Comp\23-08-13 ZR\A.cpp", "C++", 14, 0, 0, 0, 7, 21
"d:\000 Noip\000 Code\Comp\23-08-13 ZR\B.cpp", "C++", 29, 0, 0, 0, 12, 41
"d:\000 Noip\000 Code\Comp\23-08-13 ZR\C.cpp", "C++", 27, 0, 0, 0, 10, 37
"d:\000 Noip\000 Code\Comp\23-08-13 ZR\D.cpp", "C++", 27, 0, 0, 0, 7, 34
"d:\000 Noip\000 Code\Comp\23-08-15 ZR 收官之战\A.cpp", "C++", 51, 0, 0, 2, 19, 72
"d:\000 Noip\000 Code\Comp\23-08-15 ZR 收官之战\A_2.cpp", "C++", 29, 0, 0, 0, 13, 42
"d:\000 Noip\000 Code\Comp\23-08-15 ZR 收官之战\A_3.cpp", "C++", 17, 0, 0, 0, 11, 28
"d:\000 Noip\000 Code\Comp\23-08-15 ZR 收官之战\B.cpp", "C++", 65, 0, 0, 0, 18, 83
"d:\000 Noip\000 Code\Comp\23-08-15 ZR 收官之战\C.cpp", "C++", 20, 0, 0, 0, 7, 27
"d:\000 Noip\000 Code\Comp\23-08-15 ZR 收官之战\D.cpp", "C++", 77, 0, 0, 0, 22, 99
"d:\000 Noip\000 Code\Comp\23-08-18 SDCPC\A.cpp", "C++", 35, 0, 0, 0, 13, 48
"d:\000 Noip\000 Code\Comp\23-08-18 SDCPC\F.cpp", "C++", 43, 0, 0, 0, 18, 61
"d:\000 Noip\000 Code\Comp\23-08-18 SDCPC\G.cpp", "C++", 40, 0, 0, 0, 16, 56
"d:\000 Noip\000 Code\Comp\23-08-18 SDCPC\G1.cpp", "C++", 47, 0, 0, 0, 19, 66
"d:\000 Noip\000 Code\Comp\23-08-18 SDCPC\G_pai.cpp", "C++", 6, 0, 0, 0, 4, 10
"d:\000 Noip\000 Code\Comp\23-08-18 SDCPC\H.cpp", "C++", 16, 0, 0, 0, 8, 24
"d:\000 Noip\000 Code\Comp\23-08-18 SDCPC\I.cpp", "C++", 22, 0, 0, 0, 12, 34
"d:\000 Noip\000 Code\Comp\23-08-24 CF\A.cpp", "C++", 30, 0, 0, 0, 9, 39
"d:\000 Noip\000 Code\Comp\23-08-24 CF\B.cpp", "C++", 25, 0, 0, 0, 11, 36
"d:\000 Noip\000 Code\Comp\23-08-24 CF\C.cpp", "C++", 29, 0, 0, 0, 12, 41
"d:\000 Noip\000 Code\Comp\23-08-24 CF\E.cpp", "C++", 9, 0, 0, 0, 4, 13
"d:\000 Noip\000 Code\Comp\23-08-26 ABC317\A.cpp", "C++", 15, 0, 0, 0, 8, 23
"d:\000 Noip\000 Code\Comp\23-08-26 ABC317\B.cpp", "C++", 18, 0, 0, 0, 9, 27
"d:\000 Noip\000 Code\Comp\23-08-26 ABC317\C.cpp", "C++", 44, 0, 0, 0, 12, 56
"d:\000 Noip\000 Code\Comp\23-08-26 ABC317\C1.cpp", "C++", 40, 0, 0, 0, 13, 53
"d:\000 Noip\000 Code\Comp\23-08-26 ABC317\D.cpp", "C++", 33, 0, 0, 0, 14, 47
"d:\000 Noip\000 Code\Comp\23-08-27 ZR-NOIP-1\A.cpp", "C++", 29, 0, 0, 0, 11, 40
"d:\000 Noip\000 Code\Comp\23-08-27 ZR-NOIP-1\A1.cpp", "C++", 23, 0, 0, 0, 13, 36
"d:\000 Noip\000 Code\Comp\23-08-27 ZR-NOIP-1\B.cpp", "C++", 62, 0, 0, 1, 19, 82
"d:\000 Noip\000 Code\Comp\23-08-27 ZR-NOIP-1\C.cpp", "C++", 71, 0, 0, 0, 22, 93
"d:\000 Noip\000 Code\Comp\23-08-27 ZR-NOIP-1\D.cpp", "C++", 17, 0, 0, 0, 7, 24
"d:\000 Noip\000 Code\Comp\23-08-27 ZR-NOIP-1\test.cpp", "C++", 7, 0, 0, 0, 3, 10
"d:\000 Noip\000 Code\Comp\23-09-02 ZR-CSP-1\A.cpp", "C++", 62, 0, 0, 5, 20, 87
"d:\000 Noip\000 Code\Comp\23-09-02 ZR-CSP-1\B.cpp", "C++", 52, 0, 0, 0, 18, 70
"d:\000 Noip\000 Code\Comp\23-09-02 ZR-CSP-1\C.cpp", "C++", 34, 0, 0, 0, 12, 46
"d:\000 Noip\000 Code\Comp\23-09-02 ZR-CSP-1\D.cpp", "C++", 31, 0, 0, 0, 14, 45
"d:\000 Noip\000 Code\Comp\23-09-03 ZR-NOIP-2\A.cpp", "C++", 33, 0, 0, 22, 16, 71
"d:\000 Noip\000 Code\Comp\23-09-03 ZR-NOIP-2\B.cpp", "C++", 67, 0, 0, 0, 19, 86
"d:\000 Noip\000 Code\Comp\23-09-03 ZR-NOIP-2\C.cpp", "C++", 41, 0, 0, 7, 14, 62
"d:\000 Noip\000 Code\Comp\23-09-03 ZR-NOIP-2\C_test.cpp", "C++", 23, 0, 0, 0, 6, 29
"d:\000 Noip\000 Code\Comp\23-09-03 ZR-NOIP-2\D.cpp", "C++", 113, 0, 0, 0, 23, 136
"d:\000 Noip\000 Code\Comp\23-09-03 ZR-NOIP-2\D_fhq.cpp", "C++", 64, 0, 0, 0, 13, 77
"d:\000 Noip\000 Code\Comp\23-09-09 ZR-CSP-2\A.cpp", "C++", 26, 0, 0, 0, 12, 38
"d:\000 Noip\000 Code\Comp\23-09-09 ZR-CSP-2\B.cpp", "C++", 35, 0, 0, 0, 19, 54
"d:\000 Noip\000 Code\Comp\23-09-09 ZR-CSP-2\C.cpp", "C++", 40, 0, 0, 1, 22, 63
"d:\000 Noip\000 Code\Comp\23-09-09 ZR-CSP-2\D.cpp", "C++", 98, 0, 0, 0, 35, 133
"d:\000 Noip\000 Code\Comp\23-09-10 ZR-NOIP-3\A.cpp", "C++", 104, 0, 0, 0, 41, 145
"d:\000 Noip\000 Code\Comp\23-09-10 ZR-NOIP-3\C.cpp", "C++", 115, 0, 0, 3, 51, 169
"d:\000 Noip\000 Code\Comp\23-09-23 ZR-CSP-4\A.cpp", "C++", 56, 0, 0, 0, 22, 78
"d:\000 Noip\000 Code\Comp\23-09-23 ZR-CSP-4\B.cpp", "C++", 84, 0, 0, 0, 38, 122
"d:\000 Noip\000 Code\Comp\23-09-23 ZR-CSP-4\C.cpp", "C++", 37, 0, 0, 0, 21, 58
"d:\000 Noip\000 Code\Comp\23-09-23 ZR-CSP-4\D.cpp", "C++", 91, 0, 0, 1, 35, 127
"d:\000 Noip\000 Code\Comp\23-09-23 ZR-CSP-4\Redo\A.cpp", "C++", 35, 0, 0, 0, 17, 52
"d:\000 Noip\000 Code\Comp\23-09-23 ZR-CSP-4\Redo\B.cpp", "C++", 49, 0, 0, 0, 19, 68
"d:\000 Noip\000 Code\Comp\23-09-28 duel\A.cpp", "C++", 44, 0, 0, 7, 17, 68
"d:\000 Noip\000 Code\Comp\23-09-28 duel\B.cpp", "C++", 30, 0, 0, 0, 11, 41
"d:\000 Noip\000 Code\Comp\23-09-29 QBXT-Day1\A.cpp", "C++", 45, 0, 0, 0, 16, 61
"d:\000 Noip\000 Code\Comp\23-09-29 QBXT-Day1\A1.cpp", "C++", 54, 0, 0, 0, 20, 74
"d:\000 Noip\000 Code\Comp\23-09-29 QBXT-Day1\B.cpp", "C++", 50, 0, 0, 0, 21, 71
"d:\000 Noip\000 Code\Comp\23-09-29 QBXT-Day1\B.py", "Python", 0, 4, 0, 0, 2, 6
"d:\000 Noip\000 Code\Comp\23-09-29 QBXT-Day1\C.cpp", "C++", 8, 0, 0, 0, 5, 13
"d:\000 Noip\000 Code\Comp\23-09-29 QBXT-Day1\D.cpp", "C++", 119, 0, 0, 6, 49, 174
"d:\000 Noip\000 Code\Comp\23-09-29 QBXT-Day1\Redo\B.cpp", "C++", 48, 0, 0, 6, 26, 80
"d:\000 Noip\000 Code\Comp\23-09-29 QBXT-Day1\Redo\D.cpp", "C++", 103, 0, 0, 4, 54, 161
"d:\000 Noip\000 Code\Comp\23-09-30 QBXT-Day2\A.cpp", "C++", 78, 0, 0, 0, 33, 111
"d:\000 Noip\000 Code\Comp\23-09-30 QBXT-Day2\B.cpp", "C++", 119, 0, 0, 0, 54, 173
"d:\000 Noip\000 Code\Comp\23-09-30 QBXT-Day2\Redo\A.cpp", "C++", 74, 0, 0, 0, 30, 104
"d:\000 Noip\000 Code\Comp\23-10-01 QBXT-Day3\A.cpp", "C++", 51, 0, 0, 0, 22, 73
"d:\000 Noip\000 Code\Comp\23-10-01 QBXT-Day3\B.cpp", "C++", 57, 0, 0, 0, 24, 81
"d:\000 Noip\000 Code\Comp\23-10-01 QBXT-Day3\C.cpp", "C++", 86, 0, 0, 0, 34, 120
"d:\000 Noip\000 Code\Comp\23-10-01 QBXT-Day3\Redo\B.cpp", "C++", 61, 0, 0, 0, 25, 86
"d:\000 Noip\000 Code\Comp\23-10-02 QBXT-Day4\A.cpp", "C++", 67, 0, 0, 0, 23, 90
"d:\000 Noip\000 Code\Comp\23-10-02 QBXT-Day4\B.cpp", "C++", 50, 0, 0, 0, 14, 64
"d:\000 Noip\000 Code\Comp\23-10-02 QBXT-Day4\B_rand.cpp", "C++", 10, 0, 0, 0, 5, 15
"d:\000 Noip\000 Code\Comp\23-10-02 QBXT-Day4\C.cpp", "C++", 79, 0, 0, 0, 34, 113
"d:\000 Noip\000 Code\Comp\23-10-02 QBXT-Day4\C_table.cpp", "C++", 8, 0, 0, 0, 4, 12
"d:\000 Noip\000 Code\Comp\23-10-02 QBXT-Day4\D.cpp", "C++", 54, 0, 0, 0, 24, 78
"d:\000 Noip\000 Code\Comp\23-10-02 QBXT-Day4\Redo\A.cpp", "C++", 37, 0, 0, 1, 19, 57
"d:\000 Noip\000 Code\Comp\23-10-03 QBXT-Day5\A.cpp", "C++", 90, 0, 0, 1, 33, 124
"d:\000 Noip\000 Code\Comp\23-10-03 QBXT-Day5\B.cpp", "C++", 49, 0, 0, 1, 21, 71
"d:\000 Noip\000 Code\Comp\23-10-03 QBXT-Day5\C.cpp", "C++", 29, 0, 0, 0, 14, 43
"d:\000 Noip\000 Code\Comp\23-10-03 QBXT-Day5\D.cpp", "C++", 66, 0, 0, 0, 25, 91
"d:\000 Noip\000 Code\Comp\23-10-03 QBXT-Day5\Redo\C.cpp", "C++", 50, 0, 0, 0, 22, 72
"d:\000 Noip\000 Code\Comp\23-10-04 QBXT-Day6\A.cpp", "C++", 83, 0, 0, 0, 23, 106
"d:\000 Noip\000 Code\Comp\23-10-04 QBXT-Day6\B.cpp", "C++", 70, 0, 0, 0, 24, 94
"d:\000 Noip\000 Code\Comp\23-10-04 QBXT-Day6\C.cpp", "C++", 100, 0, 0, 2, 32, 134
"d:\000 Noip\000 Code\Comp\23-10-05 QBXT-Day7\A.cpp", "C++", 86, 0, 0, 53, 31, 170
"d:\000 Noip\000 Code\Comp\23-10-05 QBXT-Day7\B.cpp", "C++", 71, 0, 0, 111, 50, 232
"d:\000 Noip\000 Code\Comp\23-10-05 QBXT-Day7\D.cpp", "C++", 32, 0, 0, 0, 17, 49
"d:\000 Noip\000 Code\Comp\23-10-05 QBXT-Day7\D.py", "Python", 0, 10, 0, 0, 4, 14
"d:\000 Noip\000 Code\Comp\23-10-14 ZR-CSP-7\A.cpp", "C++", 17, 0, 0, 0, 8, 25
"d:\000 Noip\000 Code\Comp\23-10-14 ZR-CSP-7\B.cpp", "C++", 43, 0, 0, 5, 20, 68
"d:\000 Noip\000 Code\Comp\23-10-14 ZR-CSP-7\C\C.cpp", "C++", 81, 0, 0, 6, 33, 120
"d:\000 Noip\000 Code\Comp\23-10-14 ZR-CSP-7\C\C2.cpp", "C++", 82, 0, 0, 3, 32, 117
"d:\000 Noip\000 Code\Comp\23-10-14 ZR-CSP-7\C\C_std.cpp", "C++", 47, 0, 0, 500006, 8, 500061
"d:\000 Noip\000 Code\Comp\23-10-14 ZR-CSP-7\C_1.cpp", "C++", 65, 0, 0, 0, 30, 95
"d:\000 Noip\000 Code\Comp\23-10-14 ZR-CSP-7\Redo\B.cpp", "C++", 23, 0, 0, 0, 11, 34
"d:\000 Noip\000 Code\Comp\23-10-20 duel\1.cpp", "C++", 20, 0, 0, 0, 11, 31
"d:\000 Noip\000 Code\Comp\23-10-20 duel\2.cpp", "C++", 18, 0, 0, 0, 11, 29
"d:\000 Noip\000 Code\Comp\23-10-20 duel\3.cpp", "C++", 28, 0, 0, 0, 11, 39
"d:\000 Noip\000 Code\Comp\23-10-20 duel\4.cpp", "C++", 30, 0, 0, 0, 11, 41
"d:\000 Noip\000 Code\Comp\23-10-28 ABC326\A.cpp", "C++", 20, 0, 0, 0, 6, 26
"d:\000 Noip\000 Code\Comp\23-10-28 ABC326\B.cpp", "C++", 16, 0, 0, 0, 8, 24
"d:\000 Noip\000 Code\Comp\23-10-28 ABC326\C.cpp", "C++", 20, 0, 0, 0, 10, 30
"d:\000 Noip\000 Code\Comp\23-10-28 ABC326\D.cpp", "C++", 54, 0, 0, 0, 18, 72
"d:\000 Noip\000 Code\Comp\23-11-08 QCM\A.cpp", "C++", 41, 0, 0, 0, 17, 58
"d:\000 Noip\000 Code\Comp\23-11-08 ZR-NOIP-4\A.cpp", "C++", 42, 0, 0, 0, 16, 58
"d:\000 Noip\000 Code\Comp\23-11-08 ZR-NOIP-4\C.cpp", "C++", 86, 0, 0, 5, 32, 123
"d:\000 Noip\000 Code\Comp\23-11-08 ZR-NOIP-4\D.cpp", "C++", 43, 0, 0, 5, 19, 67
"d:\000 Noip\000 Code\Comp\23-11-08 ZR-NOIP-5\A.cpp", "C++", 57, 0, 0, 6, 23, 86
"d:\000 Noip\000 Code\Comp\23-11-08 ZR-NOIP-5\A_check.cpp", "C++", 13, 0, 0, 0, 7, 20
"d:\000 Noip\000 Code\Comp\23-11-08 ZR-NOIP-5\B.cpp", "C++", 43, 0, 0, 0, 20, 63
"d:\000 Noip\000 Code\Comp\23-11-08 ZR-NOIP-5\D.cpp", "C++", 181, 0, 0, 0, 69, 250
"d:\000 Noip\000 Code\Comp\23-11-09 ZR-CSP-3\A.cpp", "C++", 67, 0, 0, 0, 27, 94
"d:\000 Noip\000 Code\Comp\23-11-09 ZR-CSP-3\D.cpp", "C++", 380, 0, 0, 6, 86, 472
"d:\000 Noip\000 Code\Comp\23-11-09 ZR-CSP-3\chb.md", "Markdown", 0, 0, 4, 0, 2, 6
"d:\000 Noip\000 Code\Comp\23-11-09 ZR-NOIP-6\A.cpp", "C++", 81, 0, 0, 1, 24, 106
"d:\000 Noip\000 Code\Comp\23-11-09 ZR-NOIP-6\B.cpp", "C++", 29, 0, 0, 0, 12, 41
"d:\000 Noip\000 Code\Comp\23-11-09 ZR-NOIP-6\C.cpp", "C++", 128, 0, 0, 5, 46, 179
"d:\000 Noip\000 Code\Comp\23-11-09 ZR-NOIP-6\D.cpp", "C++", 32, 0, 0, 0, 19, 51
"d:\000 Noip\000 Code\Comp\23-11-10 ZR-NOIP-7\A.cpp", "C++", 49, 0, 0, 0, 24, 73
"d:\000 Noip\000 Code\Comp\23-11-10 ZR-NOIP-7\B.cpp", "C++", 43, 0, 0, 0, 17, 60
"d:\000 Noip\000 Code\Comp\23-11-10 ZR-NOIP-7\C.cpp", "C++", 41, 0, 0, 0, 18, 59
"d:\000 Noip\000 Code\Comp\23-11-11 LGR-166\A.cpp", "C++", 10, 0, 0, 0, 6, 16
"d:\000 Noip\000 Code\Comp\23-11-18 NOIP-2023-VP\A.cpp", "C++", 115, 0, 0, 5, 44, 164
"d:\000 Noip\000 Code\Comp\23-11-18 NOIP-2023-VP\A_check.cpp", "C++", 17, 0, 0, 0, 6, 23
"d:\000 Noip\000 Code\Comp\23-11-18 NOIP-2023-VP\A_test.cpp", "C++", 14, 0, 0, 0, 10, 24
"d:\000 Noip\000 Code\Comp\23-11-18 NOIP-2023-VP\B.cpp", "C++", 96, 0, 0, 0, 36, 132
"d:\000 Noip\000 Code\Comp\23-11-18 NOIP-2023-VP\C.cpp", "C++", 36, 0, 0, 0, 15, 51
"d:\000 Noip\000 Code\Comp\23-11-18 NOIP-2023-VP\D.cpp", "C++", 50, 0, 0, 0, 24, 74
"d:\000 Noip\000 Code\Comp\24-02-03 Constructor-Open-Comp-2024\A.cpp", "C++", 12, 0, 0, 0, 7, 19
"d:\000 Noip\000 Code\Comp\24-02-03 Constructor-Open-Comp-2024\B.cpp", "C++", 15, 0, 0, 0, 9, 24
"d:\000 Noip\000 Code\Comp\24-02-03 Constructor-Open-Comp-2024\C.cpp", "C++", 19, 0, 0, 0, 11, 30
"d:\000 Noip\000 Code\Comp\24-02-03 Constructor-Open-Comp-2024\D.cpp", "C++", 18, 0, 0, 0, 10, 28
"d:\000 Noip\000 Code\Comp\24-02-03 Constructor-Open-Comp-2024\E.cpp", "C++", 25, 0, 0, 0, 11, 36
"d:\000 Noip\000 Code\Comp\24-02-03 Constructor-Open-Comp-2024\F.cpp", "C++", 24, 0, 0, 0, 12, 36
"d:\000 Noip\000 Code\Comp\24-02-03 Constructor-Open-Comp-2024\G.cpp", "C++", 23, 0, 0, 0, 12, 35
"d:\000 Noip\000 Code\Comp\24-02-03 Constructor-Open-Comp-2024\H.cpp", "C++", 16, 0, 0, 14, 11, 41
"d:\000 Noip\000 Code\Comp\24-02-06 CF923\A.cpp", "C++", 21, 0, 0, 0, 9, 30
"d:\000 Noip\000 Code\Comp\24-02-06 CF923\B.cpp", "C++", 24, 0, 0, 0, 13, 37
"d:\000 Noip\000 Code\Comp\24-02-06 CF923\C.cpp", "C++", 28, 0, 0, 0, 13, 41
"d:\000 Noip\000 Code\Comp\24-02-06 CF923\D.cpp", "C++", 53, 0, 0, 0, 23, 76
"d:\000 Noip\000 Code\Comp\24-02-10 ABC340\A.cpp", "C++", 11, 0, 0, 0, 5, 16
"d:\000 Noip\000 Code\Comp\24-02-10 ABC340\B.cpp", "C++", 16, 0, 0, 0, 6, 22
"d:\000 Noip\000 Code\Comp\24-02-10 ABC340\C.cpp", "C++", 14, 0, 0, 0, 9, 23
"d:\000 Noip\000 Code\Comp\24-02-10 ABC340\D.cpp", "C++", 56, 0, 0, 0, 21, 77
"d:\000 Noip\000 Code\Comp\24-02-10 ABC340\E.cpp", "C++", 33, 0, 0, 1, 15, 49
"d:\000 Noip\000 Code\Comp\24-02-15 ZOI-Round-1\A.cpp", "C++", 17, 0, 0, 0, 7, 24
"d:\000 Noip\000 Code\Comp\24-02-15 ZOI-Round-1\B.cpp", "C++", 30, 0, 0, 1, 16, 47
"d:\000 Noip\000 Code\Comp\24-02-15 ZOI-Round-1\C.cpp", "C++", 73, 0, 0, 0, 25, 98
"d:\000 Noip\000 Code\Comp\24-02-15 ZOI-Round-1\D.cpp", "C++", 5, 0, 0, 1, 4, 10
"d:\000 Noip\000 Code\Comp\24-02-17 ABC341\A.cpp", "C++", 7, 0, 0, 0, 5, 12
"d:\000 Noip\000 Code\Comp\24-02-17 ABC341\B.cpp", "C++", 18, 0, 0, 1, 10, 29
"d:\000 Noip\000 Code\Comp\24-02-17 ABC341\C.cpp", "C++", 39, 0, 0, 0, 17, 56
"d:\000 Noip\000 Code\Comp\24-02-17 ABC341\D.cpp", "C++", 70, 0, 0, 0, 28, 98
"d:\000 Noip\000 Code\Comp\24-02-18 CF927\A.cpp", "C++", 21, 0, 0, 0, 12, 33
"d:\000 Noip\000 Code\Comp\24-02-18 CF927\B.cpp", "C++", 19, 0, 0, 0, 10, 29
"d:\000 Noip\000 Code\Comp\24-02-18 CF927\C.cpp", "C++", 43, 0, 0, 0, 22, 65
"d:\000 Noip\000 Code\Comp\24-02-18 CF927\D.cpp", "C++", 78, 0, 0, 0, 22, 100
"d:\000 Noip\000 Code\Comp\24-02-19 LGR-174\A.cpp", "C++", 14, 0, 0, 0, 9, 23
"d:\000 Noip\000 Code\Comp\24-02-19 LGR-174\A_1.cpp", "C++", 22, 0, 0, 0, 11, 33
"d:\000 Noip\000 Code\Comp\24-02-19 LGR-174\B.cpp", "C++", 106, 0, 0, 1, 35, 142
"d:\000 Noip\000 Code\Comp\24-02-19 LGR-174\C.cpp", "C++", 42, 0, 0, 0, 21, 63
"d:\000 Noip\000 Code\Comp\24-02-19 LGR-174\D.cpp", "C++", 79, 0, 0, 0, 30, 109
"d:\000 Noip\000 Code\Comp\24-06-01 MXOI-pre\A_1.cpp", "C++", 95, 0, 0, 5, 34, 134
"d:\000 Noip\000 Code\Comp\24-06-01 MXOI-pre\A_2.cpp", "C++", 96, 0, 0, 5, 35, 136
"d:\000 Noip\000 Code\Comp\24-06-01 MXOI-pre\A_checker.cpp", "C++", 25, 0, 0, 4, 13, 42
"d:\000 Noip\000 Code\Comp\24-06-01 MXOI-pre\A_gen.cpp", "C++", 28, 0, 0, 0, 12, 40
"d:\000 Noip\000 Code\Comp\24-06-01 MXOI-pre\C_1.cpp", "C++", 146, 0, 0, 6, 55, 207
"d:\000 Noip\000 Code\Comp\24-06-01 MXOI-pre\C_2.cpp", "C++", 158, 0, 0, 7, 59, 224
"d:\000 Noip\000 Code\Comp\24-06-01 MXOI-pre\C_checker.cpp", "C++", 65, 0, 0, 2, 27, 94
"d:\000 Noip\000 Code\Comp\24-06-01 MXOI-pre\C_gen.cpp", "C++", 13, 0, 0, 0, 6, 19
"d:\000 Noip\000 Code\Comp\24-06-01 MXOI-pre\D_1.cpp", "C++", 72, 0, 0, 1, 37, 110
"d:\000 Noip\000 Code\Comp\24-06-01 MXOI-pre\D_2.cpp", "C++", 72, 0, 0, 1, 37, 110
"d:\000 Noip\000 Code\Comp\24-06-01 MXOI-pre\D_3.cpp", "C++", 76, 0, 0, 1, 39, 116
"d:\000 Noip\000 Code\Comp\24-06-01 MXOI-pre\D_checker.cpp", "C++", 27, 0, 0, 2, 13, 42
"d:\000 Noip\000 Code\Comp\24-06-01 MXOI-pre\D_gen.cpp", "C++", 17, 0, 0, 0, 6, 23
"d:\000 Noip\000 Code\Comp\24-06-01 MXOI-pre\test.cpp", "C++", 8, 0, 0, 0, 4, 12
"d:\000 Noip\000 Code\Comp\24-06-22 PJudege-J-6\A_1.cpp", "C++", 88, 0, 0, 0, 18, 106
"d:\000 Noip\000 Code\Comp\24-06-22 PJudege-J-6\A_gen.cpp", "C++", 4, 0, 0, 0, 2, 6
"d:\000 Noip\000 Code\Comp\24-06-22 PJudege-J-6\B.cpp", "C++", 39, 0, 0, 2, 15, 56
"d:\000 Noip\000 Code\Comp\24-06-22 PJudege-J-6\C.cpp", "C++", 20, 0, 0, 2, 11, 33
"d:\000 Noip\000 Code\Comp\24-07-05 Beta\A.cpp", "C++", 10, 0, 0, 0, 4, 14
"d:\000 Noip\000 Code\Comp\24-07-05 Beta\C.cpp", "C++", 17, 0, 0, 0, 10, 27
"d:\000 Noip\000 Code\Comp\24-07-05 Beta\D.cpp", "C++", 27, 0, 0, 4, 13, 44
"d:\000 Noip\000 Code\Comp\24-07-05 Beta\E.cpp", "C++", 66, 0, 0, 0, 28, 94
"d:\000 Noip\000 Code\Comp\24-07-05 Beta\E_2.cpp", "C++", 20, 0, 0, 0, 13, 33
"Total", "-", 18971, 77, 22, 500775, 5848, 525693